-M-------------X----------------?-----|---------?--T----X------------X----|---o---------E-----------B--|---B-----B-----T---B-M-------------o----------|------M---E--T---B-------X---------------?M------
-X-E----M----------?TB|-MX-----E-----------E-B---E------M-o---M-----------------M--|-----------?-----E--MM-----X---M---------X-----------o-------------o---o--------------------------E----------------|
-------?-----------?M-----------X-Bo--XB-------------B----------------------o-----T---B----X-----T--------------------X|----M-BB-------B-----------------------X-------X-----------B---M-----E---|--T--?
--------------------B-------------T----M-T-----------------------o--|E---M--------------E-------E----?-----------------?|-----?-----------?-------------X------E---E-M|-T--------------X---T-E----?----E
------oM---------------?------------M--o--------------?-------|-E---------------------------|-------M-----------X-----BB------T----M------B?---B-o------------------E---T-----------XE---------E--------
------M----M----X--E--?--X----------?|---T----B------o----|-------T----T-ET?-T------T--T---|---------------|---------B----B--T----T--------------?---o----|--B------X----------X--M-----B--------------M
----X--------------------X-------T------------oT---X--------------M-M---E--------------------|-------E--XT-E----------B-|--T---------M---?-----B--------------------o-X------------------B-MX--------T-E
-??-----T----------E------T-X-----B----------------M--M--------B------------------T---|----T--?--X---------?-|----o------------T-XM--B--T--------|---M---------T-----------------T-X--?-o--------B--|?v-
-|T|-B-------MBT------------|--oBT--MBEo-?|-M-||----T-?-?B-M-|--|--B-X--B---EM-E--B----oM-B-|-ooE------T-B|----|-EX-|o-T--Xo?MT|-B--oM--X-T----o-------T----|-|MX--oXX-ooo----E---o-E--|-M?------?----fT
--TX--o-----B--X-M?|----BE---B---X----B----o--Eo?-----?-B----|------B--T----E-M--o|?---E-------?-----B--------o--------|?-X|---X-ToX--E-E---o-----?-|oX-M-------MM-X--E------X---T---M|-E-M---E|--X--BfX
-?B--?-----o-B-----M-|---------|----|E-----X--M-----T--o--X--E-|-Eo-Mo-ETE--MM|-T------------?E---o-------|-E--|--|-T--oXX-------XX-o?-?TB--oM---T------T|----|----T------M-XB---X-B----o---M|M--X----f?
-T-----T-?--To---M---B|X--?-M|---?X-----o-|M----oMB-T-MMT--TTB-E-----o--------B----B--------------|M-B-T|--M-|---?T----------Eo---E-----?---|T----o-----B--E----B-------B-Mo---X---BXT---XX-|o--?----Ef-
--M---T-T----------E----E|E-----T-|XE-T-------B------T------Mo--X----X-E-?--EM?-M------T??---------?--------E-|?B--E?--B----XBB------E---?|---T-?X-T-B--X---|M-T-ME-o-----T--?--?--------T|M----E-M---fT
--o?----Bo-Eo---MEE---?-?-?-E-M------X----o---E--|---------B-o---o--X--------B------XX-|-?o-T-o----E---Bo-?--|-o-o|--?T-MB----?--TE--B-Bo----E-B-------M------TE-oB--TE--To----------|-?--o?-------E|-f|
m----------B---o-XT-----E-TT-E?|----M--?--MBX--T--B----M---B?--EX----M---|----M|-M-----M--X-BXE----E-BMX---E----------|--Eo-----ME-----T--M--|----E---------?TT?-o-X-------M-------X---|--B--?-----M-MTo
XXXXXXXXXXXXXXXXXXXXXXXXXXXXXXXXXXXXXXXXXXXXXXXXXXXXXXXXXXXXXXXXXXXXXXXXXXXXXXXXXXXXXXXXXXXXXXXXXXXXXXXXXXXXXXXXXXXXXXXXXXXXXXXXXXXXXXXXXXXXXXXXXXXXXXXXXXXXXXXXXXXXXXXXXXXXXXXXXXXXXXXXXXXXXXXXXXXXXXXX
