-------------------------------------?----------------------------------------B-------------M----------------------------------------------o-----------------------------------------M------------------
---------------------------------------------------?-------------------------------------------------o------------------------------------?o------------------------------------------------------------
---------------------------------------------------o------------------------------------------------o--------------------------------------------------????????-----------------------------------------
------------------------------------------------------------------------?---------o-o--------T----------------------------------------------------------------------------------------------------------
-------------------------o------------------o----------------------------T-------------------|----M------------------------------------------------------------??????--BBBBBBBB-----M-------------------
-------------------------------------------------------------------------|-------------------|------T----------------------------XXXXXXXXo-----------------------------T--------------------------------
-------T--------------B--------------------------------------------------|-------------------|------|-----T----MT-------------------Xo---------------------------------|--------------------------------
-??o---|------------------------------------------------T---T------------|-------------------|------|-----|-----|-----T------------XX-----------B----------------------|X------------------------------v
-------|------------------------------------------------|-M-|------------|-----------------XX|XXXX--|-----|-----|-----|-----------XXX----------------------------------|X-B--------------T-------------f
-------|-o------------------------------------------?---|---|------------|------------Xo-----|------|-----|-----|-o---|----------XXXX---------------------------------X|X----------------|---X---------f
-------|------------------------------------------------|-M-|------------|-------------------|------|-----|-----|-----|---------XXXXX----BBBBBBBB--------------------XX|X----------------|--XT---------f
-------|----------------------------T-------------------|---|X-----------|----------XXXXXXXX-|------|-----|-----|-----|--------XXXXXX-------------------T-------T---XXX|X----------------|-XX|---------f
-------|----------------------------|-------------------|---|----???---o-|-------------------|------|-----|-----|-----|-X-----XXXXXXX-------------------|-------|--XXXX|X----------------|XXX|---------f
-------|---------?------------------|-------------------|---|----T-------|-----T-------------|------|-----|-----|-----|-XX---XXXXXXXX-------------------|--T----|-XXXXX|X-------------X--|XXX|---------f
m--E---|-----------------E--E----E--|------------------?|---|--E-|E---E--|-----|-------------|------|--E--|---E-|-----|-XXX-XXXXXXXXX------------------E|--|XXXX|XXXXXX|XEE--------E--XXX|XXX|-----E---X
XXXXX--|XXXXXXXXXXXXXXXXXXXXXXXXXXXX|----XXX--------XoXX|XXX|XXXX|XXXXXXX|XXX--|---XXXXXXXXoX|XXXXXX|XXXXX|XXXXX|XXXXX|XXXXXXXXXXXXXX---XXXXXXXXXXXXXXXX|--|-X-X|XXXXXX|X--XXXXXXXXXXXXXX|XXX|XXoXXXXXXX
