--------------------------------------------------------------------------------------------------------------------------------------------------------------------------------------------------------
--------------------------------------------------------------------------------------------------------------------------------------------------------------------------------------------------------
---------------------------------------------------------------------------------------------oM---------------BBBBBBBB----------------------------------------------------------------------------------
------------------------------------------------------------T-------------------------------------------------------------------------------------------------------------------------------------------
------------------------------------------------------------|-------------------------------------------------------------XX----------------------------------------------------------------------------
------------------------------------------------------------|---------------------M---------------------------------------------------------------------------------------------------------------------
------------------------------------------------------------|-------------------------------------------------------------------------------------------------------------------------------------------
------------------------------------------------------------|----------------------------o---------------------------------------------------------------------------------T---------------------------v
------------------------------------------------------------|--------------------------------------------------------------------------------------------------------------|---------------------------f
----------------X-------------------------------------------|--------------------------------------------------------------------------------------------------------------|---------------------------f
---------------XX-------------------------------------------|-------------------------------------------T------------------------------------------------------------------|---------------------------f
--------------XXX-------------------------------------------|-------------------------------------------|------------------------------------------------------------------|---------------------------f
-------------XXXX----o--------------------------------------|-------------------------------------------|------------------------------B---------o-------------------------|---------------------------f
------------XXXXX-------------------------------------------|-------------------------------------------|------------------------------------------------------------------|----------------------M----f
m----------XXXXXX--------------------XEXXXXXX---------------|-------------------------------------------|--------------------------------------E------------E--------E-----|-------------E-------------X
X------XXXXXXXXXXXXXXXXXXXXXXXXXXX--XXXXXXXXXXXXXXXXXXXXX?XX|XXXXXXXXXXXXXXXXXXXXXXXXXXXXXXXXXXXXXXXXX--|XXXXXXXXXXXXXXXXXXXXXXXXXXXXXXXXXXXXXXXXXXXX?XXXXXXXXXXXXXXXXXXXXX|XXXXXXXXXXXXXXXXXXXXXXXXXXXX
