-----------o------------MB-EM?-----------------------|-----EB---E--------------M-TE-----?---X----B---------------------ET---M-M--B-?--E-T--------------------B-M---------------|-M----B--?-------------?
-----M------E-M--BB----------------B|-------|---------------------M---T-----------------B-------E------------------------BE-------------M-----------MX---o----T---B-------M------EB--------------------o
--B---o----TM------------M--B--------------?----------o-T---?----TT-----XM----?-?---X--------------E-|--------E--------X----|--E--X-----------T-------------X-----------EM--M----------------------?B?--
--------E-------T--X--B---------------X-M--------M---M--o---------------o-|-----------------------------------X-------M----?---EB-E----?----B?--------------------------T--M----------E-X---E----------X
---BT--T-|-------?----------|----B----X---------------------B-------E-T-------|----------------?----?-?---------o----B----|--------E----------------------T---------------?----M-----M|-------------M--|
--------|-------------?o-------M------------------E--o---B-----B----------------o--T--------M------B-|----T----------|---M-?---------------E-----E----B---------ET------T----M--B----------?--MB-----X-?
---------------------------E------E------------M----o----B---o----------|-------------------|------M--o-------?----M-----------B------------------o---------B------------B--oT-------------T--|-----X--?
---?---------M--E----------------o--------?---------T-----E-X-------------------?---------------------o----X---T-Xo?o----E---------------B-X---------M--?------------------M----------------EX-------ovM
-------BM-----M--T--M--?--MX-M----o--ETM--T------------o---M-?--E---E---?-|------M--M----o---o----X---M-BMM-o-o-o---o-----------M-MM|-o----X|---------o-o?|-B---XB-X---------TT--o-B------B----?T-----fo
--E-BB-?-|X-T-T--M--BX----E--?-M-B-------|o--E---X--------EEM---?-TE-----B---E----X?----B-BT-----M-|----?----X-EXX-------X-o-------M---T------oo|-BM---|-||-----X-|BE-M-M?-?--------T-E-T-B-B-Bo---TBofT
---T?|XB--X-o-T-oT-?|B-ET--E?Mo-----E--oB-XE-|X----BT--ME------|oX-T----M----B-E--E--Mo--|--B--T-B----o--TM?X--X-o--|BE--------T|T-E------M--T|-----?--E--------X-|----------T----------M--o--B-?o-o--fX
-o--?--B--|E--E?---o?--?XT---------?TB----EBEo---XX----??--?-T?--|-T--|---?o----To--B---EXX--------o--?X-EX---?---E----M-|?-T----M-----?T--B-TT?--T-o?--|---E-M--?-oT-oB--?-??-M-Eo---o-X--o--M--B--B-fT
-T---------M-B--|X|-o--T------B-E----M?--X|?EoX-----BM---o------X--------B-B--------EB---------B---?--XM------B------X-T-M------EX----X--------Mo--------M----|X--T----T--o----oXE-------T--------?--ofM
--------|-B---Eo?-----B--E-?---o--B|oT------M---M---|---E---E-------|-|---?-M-T----o-X|-|--?--o-X----TB------TTX--B--BM--T----?--X-BT--E-B?-----XETMB?-T-----?--?--?|MM-?-M---------X-|---X-T---------fT
m-----E-?-o----B--o-E------E-----X-T-o--XMM---o---oT-E|M-|T-M-T------M--X--oX--M-|XEBB--EMT--XB-----?--M---B---?-----MB--EB-TB--|oB--ToB--T---MMB----B----B--B-----o---E------o-T-M|--M----T-------B--Bo
XXXXXXXXXXXXXXXXXXXXXXXXXXXXXXXXXXXXXXXXXXXXXXXXXXXXXXXXXXXXXXXXXXXXXXXXXXXXXXXXXXXXXXXXXXXXXXXXXXXXXXXXXXXXXXXXXXXXXXXXXXXXXXXXXXXXXXXXXXXXXXXXXXXXXXXXXXXXXXXXXXXXXXXXXXXXXXXXXXXXXXXXXXXXXXXXXXXXXXXX
