---------X-----------B-----------------------M----------------o------?---------------|-----------o-T----B---M---------------|---------------T-------------------------|M-----B----E---------?---|--X---o
------------------------M--|--------------------|o-----------M-o------?---------------B----?---?o-o------o--------------|T-------o------------X----?---|---------E-------------------------------------T
---o---M-----X--|---o--B---B---X--T----B-----------?---------T--E---M--Mo--M-------?-----o----B-B--------------------------------|-------------------------------------o-------------X-----------------E
--?----------------o---------------T-------------M-M-XX|TE---E-----------T?-------------o--T---------T-----o----?---------------------------EB---|--T----o------M-----M---o---------------T-----B--M---T
-----X-X-----------------------B--E------------X-------------X-----------X-|-B------|--B------T-M-----|---?-B--------------?----------o--MBXX---B----------------X-----M-?--------------M-B---T--------o
-T|------------------T--------------|-B----X--B-------E-E-|----------XE-------T------------------M----T-------?-o------------------------T----o----B-----|-------E-E-----------------------------X|----?
------------------|-----?---------M?-?-E-o-T-----------------------------T----B--|-----B--------TM--------------M----------|---------E-E----E|--o------Mo------------o----------------?-B--?-----------o
-o------M-----o----o-----------M---------------M---------B-BE------------BTB---------?------------|-----------------------------?-E----B-----|--------T-----|---?-M----M--T---------------------------vX
---T---E--M--|------|BB--o-M--B---X--|--T-?o--o-T-M---T-M-------?E----M----oT--?---E-----|B---ETo-------|T-E------Bo-?-M----T?ToE-M---X-E--M---BE-o--X-X--ME----E?---MB-M--|MM-|-B----T?-o-X--E---X--TfE
-?-E--o-MMTTE-T-?T-M--MT----?--E?TX-------E----|--------M-?----BX------o??--T---E?X--B------M---?---o-?X??--?-M-X--oB---B-T--MMM---?E---?-o------?--o--?--?-BB--o---o-oB-B-o--B?----X-M-B--|X--oB--oB-fM
--|M-B---B-E----M-BXT--------E----B|-?-----?--T---EM-?---EM-----X---T--T--T|---oT|----------o-------M-----M---BB---------o-|-|-M---?--|---oo-T---T-E--o----E----o--XM----BB--?-----T----T--E-T--ET-T--f-
--o---XXXX-TX---X-EX-|-B---EE--B---X------T---------X-|--Mo--|-|-oT-oT-o-----E---|-M--------X?----XBB--|M---?o-----X-|-oE---X?-E---M----|-|-?----E-|o?-B---TM---XM-XE?E----------?-----TB--M--?------|fB
-|-T--?-X-MM-ET|o-?-|--?-|-||------?---EBT--X---To---E?----E-M-o|-oT--?MT-o-B|?--oo----E-B-|?-?X|?------T--M-|E-E--|---M-T|?-E-----T---X---?-----BBT-----o-------X-XT----?ET----o--B--||X--oBo---E-E--fT
-|-oEo?-------oM-B-|----|-B--oB-------?---?----E?------|-oE-X-EB|------?----B---X-------M--M-----M---T-X--oXEM-B--X--E|----M---BM-T--?ToMX-----E--X--?E--B--X---E?-------B-B|--E--M------o--B-X-X||o--fB
m----o--B----M-oTT--|--------?-?----B---|---M--B----EoT-BB----Xo|--XoE-X-|----B-o-?-EM?----?--TM-BE--Xo--M-ME---?oB-X----B--X-E------TTB----?---M-T----E--X----M-o-?T-M--?o-?-T--?------|----|BE-E-T|?-?
XXXXXXXXXXXXXXXXXXXXXXXXXXXXXXXXXXXXXXXXXXXXXXXXXXXXXXXXXXXXXXXXXXXXXXXXXXXXXXXXXXXXXXXXXXXXXXXXXXXXXXXXXXXXXXXXXXXXXXXXXXXXXXXXXXXXXXXXXXXXXXXXXXXXXXXXXXXXXXXXXXXXXXXXXXXXXXXXXXXXXXXXXXXXXXXXXXXXXXXX
