--------------------------------------------------------------------------------------------------------------------------------------------------------------------------------------------------o-----
---------------------------------------------?------------------------------------------------------------------------------?---------BBBBBB-----------X---------o--------------------------------------
-----------------------------------------------------------------------------------------------------------------------------------------???------------------------------------------------------------
-------------------------------------------------------------------------------o---------------------------------------------??------------------------------------------T------------------------------
-------------------------------------------------------------------------------------------------------------------------------------------------------------------------|------------------------------
-----------------------------------X---------------------------------------------------------X---------------------------------------------------------------------------|------------------------------
-------------------------------------------------------------------------BBB-----------X---------------------------------------------------------------------------o-----|------------------------?????-
-------------------------------------------o-------------------------------------------XX--------------------------------------------------------------------------------|-----------------------------v
---------------------------------------------------------------------------------------XXX-------------------------------------------------------------------------------|-----------------------------f
---------------------------------------------------------------------------------------XXXX------------------------------------------------------------------------------|-----------------------------f
---------------------------------------------------------------------------------------XXXXX--------------------------------------X--------------------------------------|-----------------------------f
---------------------------------------------------------------------------------------XXXXXX----------------------------------------------------------------------------|-----------------------------f
---------------------------------------------------------------------------------------XXXXXXX---------B-----------------------------------------------------------------|-----------------------------f
------------X--BBBBB----------?X--------------------------------------------------T----XXXXXXXX--------------------------------------o-----------------------------------|-----------------------------f
m----------XX---------------------------------------------------------------------|----XXXXXXXXX-----------------------------------------E-------------------------------|--??-----------E-------------X
XXXXXXXXXXXXXXXXXXXXXXXXX-------XXXXXXXXXXXXXXXXXXXXXXXXXXXXXXXXXX-------?XXXXXXXX|XXXXXXXXXXXXXXXXXXXXXXXXXXXXXXXXXXXXXXXXXX--------XXXXXXXXXXXXX--XXXXXXXXXXXXXXXXXXXXX|XXXXXXXXXXXXXXXXXXXXXXXXXXXXXX
