---------------------X-------------------------------?----o-----?????-------o-----------------------------------------------------------------------------------------------------------------o---------
------o---------------o-----------------------------------------------------------------------------------------------------???????---------------------------BBB------------------------------B--------
-------------------------------------------------------------------------------------------------------------------------------------------------------------------------------------o------------------
----------------------------------------------------------?-------------------------XXX----M----------------------------------------------------------------------------------------T-------------------
------------------------------------------------------------------------------------------------------------------------------------------------------------------------------------|BBBBBBB------------
----------------------------------------------------o-----------???????-------X----T--------------------------T--??????------T------------------------------------------------------|-------------------
-----------X-X-------------------------X-------------------------------------------|--------------------------|--------------|------------------------------------------------------|----------------T--
-----------XXXX--------X-----------B--XX-------------------------------------------|--------?????-------------|--------o-----|-o--------------B--------------????????---------------|--------??????--|-v
-----------XXXXX-------XX--X---------XXX-------------------------------------------|----------?----------T?---|--------------|------------------------------------------------------|-T--------------|-f
------T----XXXXXX------XXXXX--------XXXX--------------------------------T----------|---------------------|----|--------------|------------o-----------------------------------------|-|-----X------X-|-f
------|----XXXXXXX-----XXXXX----?--XTXXX---------M---------T-----B--X---|-----T----|---------------------|----|--------------|------------------------------------------X-----------|-|------------XX|-f
-?????|----XXXXXXXX----XXXXX-----TXX|XXX-------------------|--------XX-o|-----|----|-----------------?---|----|-?------------|-----------------------------------------XX-----------|-|-----------XXX|-f
------|----XXXXXXXXX---XXXXXX----|XX|XXX-------------------|--------XXX-|-----|----|--------------------B|----|--------------|----------------------------------------XXX-----------|-|----------XXXX|Xf
-B----|----XXXXXXXXXX-XXXXXXXX--X|XX|XXX-------------------|--------XXXX|-----|----|---------------------|----|--------------|-----------------?---------------------XXXX-----------|-|---------XXXXX|Xf
m-----|----XXXXXXXXXXXXXXXXXXXXXX|XX|XXX-E-----------------|--------XXXX|-----|----|-------------E--E----|B---|--E-----------|-------------------E---------E--------XXXXX-----------|X|XE------XXXXXX|XX
XXXX--|XXXXXXXXXXXXXXXXXXXXXXXXXX|XX|XXXXXXBXXXX-XXXXXXXXXX|XXXXXXXXXXXX|X-?XX|XXXX|-----XXXXX---------XX|XXXX|XXXXXXXXXXXXXX|XXXXXXXXXXXXX---------XXXXXXXXXXXXX--XXXXXXXXXXXXXXXoX|X|XXXXX--XXXXXXX|XX
