--B-----X------------o----------------------------------------------E-----------M-T------E---B-----o------E--EE------?--------------o---B----T-------------------T---------E-----------------X|--------T
-----TX----------------M---------MM---E----o--?----------|------------|-----?----B-T--B----XE------------------|---------M--------|---M?-------B------------?-o--------------|---------------T-------B--
--------------o---?---M------------Xo--------------|----B---T---|---T-------------B-----B-B---X------?--?----?-T--o--E----T-T-----------B-----X--------T--------------|X----X---------E---o-|-----E-M--|
---E-----X------|X------X-T----?-----------------?---M-E-------------|---?--M-----B-o------------Too----E-----|o--------|--------o----------|M-E-----|-------o--------E----------T-B------------|T---E-o
--E------------|--X-T----------X--X----------E------B-B-----E---o----------X------------|M--o-------X-X--------|M--------o---o-------|---------?----------------M--------------------|-------|---------M
-------M--|-------------T----------------?--------------------------|-----B---------------T------------------o-----------T----M---X------B----E----------?-----?-----------E------T---M----------------X
----------------------o--------------|--?-------E-M----X--------------------|---B-------------EE---T-----------------M----o------------E-X--X-T---------------?-----?-------------E-------o-------E----X
----?Eo-------------------|--T-----E-------?--X----BT-------X--|-X--------|-T-------o-----M-----------|?----------M--------?-------------------?-------o-X-----|---------------|--B--|---?-T------T?X-vo
-Bo---ET-----M--BE---B-T--T|-XBX-BT---BT----oT------MT|--?BM-E------|----T-E-E|--T--?o|--X|-M-BT-----E----Boo-|--o-M---------X--M-----E---TM-|-------MM--T|--|XoT--B|-T-T----T-E----||----T---E-------fM
-E------M---ET---T---?--TME?Eo--|M?E-T----Bo------XT----?--B-XEE|-M--?--X------E---o-|--?---B-------T-----X---T--ooo-----o------X?--T-------?B-------------E--M--|--||BE--------?-M-----B-T-E------|--fE
-X---BX-E-?-B-X--BX--o-------BX-------TXB--?-E?--------T-?--------T-?o?-----E--?--E-To?-X---E--o--oX--|-M-----?----M-----E-------X-X---Eo---E-E-----T-o-E--------X------XEM|-?--B?------BM---o----B|-Mf|
---X-o-oo-B-M--|M-------------|Bo--TBM--o|---M--|--XM---M---MBB--MT-?XB---Mo------T----EMoT---B-E--EXTE--E-o-----M--XX--------MBo--TM-----------T----------|----X|oM-o--?----M---oXo-o---T--o-T-oX----fX
-?--?M-X--o----T-|----XE---B-Eo-|E?X?X--T---------M------TE---------?oMB-----T-XT-BBo-?BM-oTX--------o?---B---------E--------B--ET|-o|-----?------BBB-B---|-M------?-X--o?MX-|-B-|B--|-E----?----o-|--f-
---?-|-X---T---------B----B------B---E?-----B---T----E---M-----|M------E---E--TE-T---X---|oM--T-?-----E-EX----B------------E-------MX-XX---TX----?o-M----------MT----B--oX------E-E?-T----E|--X---E-M-fM
mM-?-o--Mo--M---o--|----?----EE--|-|---BX-----o------Bo--X---X------|-BMX--To-XBB-X-----M-Xo-E----o--X----------?M--ME--------|o---E-|---?-E-B--BB-M--E-X-----o-M----------M--oo-M-|-BX-----?-M-EX-|-B-B
XXXXXXXXXXXXXXXXXXXXXXXXXXXXXXXXXXXXXXXXXXXXXXXXXXXXXXXXXXXXXXXXXXXXXXXXXXXXXXXXXXXXXXXXXXXXXXXXXXXXXXXXXXXXXXXXXXXXXXXXXXXXXXXXXXXXXXXXXXXXXXXXXXXXXXXXXXXXXXXXXXXXXXXXXXXXXXXXXXXXXXXXXXXXXXXXXXXXXXXX
