--------------------------?-oE----M-----------X-----------X----------------B--------------?-------------?-----------------------o------X-------------?-o------------------------BB--M-------------MB----
-----------------------X------------------o--------------------------------X---------o-----------E---Eo------------------------?--------------X--------M------------B-------------------o--------B---M--
-M-----------o---------EX-X------?---?---------o----X-----?----X-----E-B--------------------?-E---E--M------------------o------------------------M--------------B---?----X--oBo---------------E---------
----------X-E--------M-----------------XM-------M------o------------XM---------------B-------------?--------E--------------?-----X--------------------------------B-o---------M------------o------------
-?--------------?-XB---------M-M--M---M----------o----M---------o-------------Mo-----o-----------------o---------T-----B---?---E--E--E--------B-----------------------------------------M---------------
-E--M---E--B-----B--------B----------------------------M--?-----o--------E---M-------------------?--Eo-o-------------EX------M-------------------------------------------------B----------E?-X------?---
----M---BMo------------XX---------M--------------------M-?---------X-?-----------E--------------------------E----X--B---------------M-------?----B-----------M-----?------------------------B---M---B---
------------M----?----?-------M-----------M---X--------------X----------Bo------M?---------------Eo-------------------------?o---------?--B-------------oE--X-X------B---E--------------------------E-v-
-----B----o---o--E--------------o--EBB--E--EM--EEM-----X-----?--------E--oM--EE-BMBM--------X-o-B-E?--E--X-?---E-XB-?-M-----E-----MoB---XB---E-B----o-B--X---E---oo--??---B---B?M-X-X-X-?------M?-X-XMf-
--E--o--?--E??--o----?--?BX----E-----?-o------E--o-----Bo?------o----ooEM--?-----?-E----?------------Xo---E--?---T---BEXB-M--?X-?-E------B-?ETT----------Mo-oE---M?-M---?-M-?-M-o--------M------------f-
---oEX---?-------?----MB---E?-B-BX------E--M??M------------?--E--E------------X---------B-E---?B-BB---M---?---Mo-|X-------B-----B--?--------------?--E---------------M--B--------B-----Mo---B-M-------f-
----EXE--?-----BT----M--M---BX--?----MB------Eo---B-T-------E?XBMM-X-M-----Mo--M------E----Moo--B--o-------oBB--E-X-B-----X---?---BE------M-o-Xo---E--M-E----?---B--M----B----B-MBX-----B----o-----BB?f-
--B-XMBB---o--X--EXM--EBTMM------T--?-B-?--o-o-M----------E----E-?-?-oM--M---?----o------X---T---E-o?--?---------E-?X-B-----B--B-----------o--E---X----------MB----BM-o---B-o-M---o--E------BM---E-M--f-
----o---ET-----E-XBX---X---------T---M-?M--B--ET-----XX?--?EM--MM----------------T-------T-------X?--X---XE?--B-B-------ET--?--M----------B-To?-M--MEB--?-------T?-T-----X-?---?---o------X-----XE--?-f-
mE----|-E|--oB-B-T---EE--XX-o--EE|--X?-E---T-?X||MX--|-?B--oT--EMM--------T?---|-||-BTo--|--T-|-B-B-MT-E-------E-MX--Xo--|-X-B-----------X-?|-B-XMMM--M-T---|-MT|--|M-------XB-|oM---|---|--o|---BMEX-f-
XXXXXXXXXXXXXXXXXXXXXXXXXXXXXXXXXXXXXXXXXXXXXXXXXXXXXXXXXXXXXXXXXXXXXXXXXXXXXXXXXXXXXXXXXXXXXXXXXXXXXXXXXXXXXXXXXXXXXXXXXXXXXXXXXXXXXXXXXXXXXXXXXXXXXXXXXXXXXXXXXXXXXXXXXXXXXXXXXXXXXXXXXXXXXXXXXXXXXXXX
