--------------------------------------------------------------------------------------------------------------------------------------------------------------------------------------------------------
--------------------------------------------------------------------------------------------------------------------------------------------------------------------------------------------------------
--------------------------------------------------------------------------------------------------------------------------------------------------------------------------------------------------------
------------------------------------------T------------------------------------------------------------------o------------------------------------------------------------------------------------------
------------------------------------------|-------------------------------------------------------------------------------------------------------------------------------------------------------------
------------------------------------------|-------------------------------------------------------------------------------------------------------------------------------------------------------------
------------------------------------------|---------------------------------------------------------------------------------------------------------------XXX------BBBB--------X------------------------
------------------------------------------|------------------------------------------------------------------------------------------------------------------------------------------------------------v
------------------------------------------|------------------------------------------------------------------------------------------------------------------------------------------------------------f
------------------------------------------|------------------------------------------------------------------------------------------------------------------------------------------------------------f
------------------------------------------|-----------------------------------------------------------X------------------------------------------------------------------------------------------------f
-----------------------------------X------|-----------------------------------------------------------XX-----------------------------------------------------------------------------------------------f
-----------------------------------XX-----|-----------------------------------------------------------XXX----------------------------------------------------------------------------------------------f
-----------------------------------XXX----|-----------------------------------------------------------XXXX----X----------------------------------------X-----------------------------------------------f
m----------------------------------XXXX--B|-----------------------------------------------------------XXXXX---XX-------E-------------------------------XX----------------------------------------------X
XXXXXXXXXXXXXXXXXXXXXXXXXXXXXXXXXXXXXXXXXX|XXXXXXXXXXXXXXXXXXXXXXXXXXXXXXXXXXXXXXXXXXXXXXXXXXXXXXXXXXXXXXXXXXXXXXXXXXXXXXXXXXXXXXXXXXXXXXXXXXXXXXXXXXXXXXXXXXXXXXXXXXXXXXXXXXXXXXXXXXXXXXXXXXXXXXXXXXXXX
