-----M------------------------X-o--T-----o--------?----------|--------------o---T-----Bo--------------o---M--------------------------------E-----X-------------------o-------------ET----M-------------|
---X-B-T-----------B------------------T---B---------EX-X------T---T-----------------------M|------|?-----E---------?-----------M-X-----------M-M----------------------?--------T----T------?-------X---T
----------------------X-------------BB---------------B---------|--X---------------------X----------?-------?---------------|------|----?-----------E-|----------o----------o--B--X-----?------------T---
-------------------M?------X--E--------|-------|---------------------o----------X---------------------------EB--T-----------o----?-|----?--T?-----T--M-----------oB------?-------B---------------------o
-?--|B|------E----Mo|--B---------o--------B----o----?--------T---------M-----M-------------B-T--o---------B---E------------M-M--------B-X-----------------T--------------------X-------------oo-X---X--E
----|--o----------------------M------------B--------XE-----?-EM---------E----X----------B------E--E--M---?--|------M-------------o-------------M-------E-----o-----------------o------------?--------|-M
----|----------B--------T--B------E---------MX------?X-o--------------B----|--|--------------?---o----?------------o------------oB----T--------B-TE--------B-|---------------?-o--o------|B---BM-oT--?-E
-X----------------B---T-|---------|-------T-----o-X?-------oB--T-----?-------E-E------------?--B----E-------------|X----------o-----o-----B----------------M--------------M----?----------------------v-
--o-T---|X---B-MX-----M-MM-B--?----BT?XXE-----|M---M-XXMo---XM-B?-|------T?-?-ET----M-M-?E-MT-|?---T-----------|---T-|--X--T---B-T--M?-M?--B--B----B-B--E|oMX------TE---|B|o-E-E-E-oo------T?----BT---f|
-||X----|---?ooo------X--X---E-X-M--X-o--X-T--E|-----oT-E--?oT|XT|--T-o-----T----X-M--?o-E?--------M--B--MB-XM-M-MB-T---?--M-o---TE-----BM--M------------oo---?B--|-B----?--|--ME|M|--X--E----M--Xo-|ofX
-M-E-?ET------?--B--------|--oXT---|-Bo-|T--T?-MoE-X-----X-o---X---E-X---M--B----------X---?B--?----?TBT--M------X-----X--B---T-M-o--|---------o-----M-----T-B-BMMo-|M--X---T?E-----?--------E-T-T----fX
-|-?-----M-E---------BBTX|M|oX----E--BM--|E-B-|-|---oE--o-o--o--------------|----B|TT----------?--?-E------TE?E--B-M-X-----T--MX-XM--|-?---o|oM?--|--B-o--|-T----||||?|-X--?oE---------?---|X------|-Xf|
--BB--?-?-B---B------X-X--B?E--B-?|---XE-?----------X---MTTX---E?-BT-T---------o-B-BEET---Bo---M--oB-----------MB-o-E-----Mo----??------?--M---E------------X-|-o-o?|-BB---E-BB-----o-|-|X---XX-?-T|-MfX
--oT--E--E------E----M--X-------M-M-o----?-----X----------X-----TB-----X-T?-----B-T---|-T?-T--X?B-|-T---XXEE----M-----TB--EXMo-TB|?---oE---T------o|--E--|---M|-|--|M-----|-B---?||--ET---|-EoT----X--fX
m---M-M---------E--|-------??-B--ME--E----M----?T----T-----T--X-M-?o-M-?T-EX-E-----oTBE-E-X-T-----o-E--X-------T-|?M-------MT-To-M|X-X-T--?-M-MX--B?o-B-BBB|BE-BM|-??MXo-TXMo-?-|EB|-ME---|-----X-|-T-|-
XXXXXXXXXXXXXXXXXXXXXXXXXXXXXXXXXXXXXXXXXXXXXXXXXXXXXXXXXXXXXXXXXXXXXXXXXXXXXXXXXXXXXXXXXXXXXXXXXXXXXXXXXXXXXXXXXXXXXXXXXXXXXXXXXXXXXXXXXXXXXXXXXXXXXXXXXXXXXXXXXXXXXXXXXXXXXXXXXXXXXXXXXXXXXXXXXXXXXXXX
