---T---B---?-----------?--|---M?--X|T-------X----|----------X----------?T---o-----------------|--------B------------X--M-------------E-E-----------M--?----o---B----Mo-------?-------B-------X------?---
----------------B----??--------T------|----------E-------|-------------------|-----------M-------------------------------------o--EXE-M----T------------------?---|----T----------------X-------E------X
-------------EX---T-------------------o---------------X-----------B------|----o-----B------?------B---o---|------------------?--------T--|----------|---------------------------------TT-----?B--------E
-----M-oB----B-M----?-B---E-------X------------oB-------X?M----M--------------------E-T---|---E-------------------------|?------------------|--?--o-E----X------X-----------T--------------------------|
-----|-M---------E--------T?--?-----|---?----------------------B-B------X---------------------?----X------------------M----------------M---------X------------T---X-------X--E----------------------M--T
-|----X-X--E--T------B|-------X-------------|------------T--M-------------X------|--X---E--M-----------?------------------E--------T------------------Eo--------B------B------------|--TB-----------|--M
----------o----------?---B----ET-----X-X---------?-----E---------------?-B---------|--EX------ET---o--E-B-----------------T----?|----B-------B|M-T---------?--------MT--X?----T-------------X--------o-|
---------------M-----------------|---E-------------o-----B------------B-----|--E-------?----o-?---M------------------------------B-----X------X---X---M-----------------MM-------------------T-----o--vT
-?o--o?--o|TTo-||BX---X----T--M-|-B--X-M--T--X----?---?---|---B---X--B------To--M-?--|-----?-M-X-oE---------EMM--|?------?--X|o--E|-XXMB----E--T-----------B-----M--T-?-X-----E|o?--E-B--|X--o---ME---fE
--M--MToTB-----?-?----|o--EMT|--------|-T----o---T-oM|---|------o?E-TX?T-ME---oX-X--|BE-M--o-?E|-o--M-?--E----TE---X---|-o-B|oTMEMoTE------oT----------M-o|--T-----EXX--------TE--B|XE-|--|-|--o---?--fB
----ME--|-----B---?E-|-X|E-M-E--?-|B------?----T-TTT-----B-|-||-------|||M-o-T--oM--|X-X-----------------?--oo?ooo-?-TM---?-----??---o------ETM-|-Bo-TMXB?---?---|XM--M|--Xo?X--?---BX---------XM?MB-TfX
-?MEE-|-M-B-|-o--XE--?--T---o--?----X-?E---oX--------T---XX-T---|M--X---B--XMT--M--B---|------T--B--?-----o-|--XB-|-oT-B-----M-------M--EoE-E-M|To----B--E|M-X-M--TET----BM--M---X|EE?|o-T-o-----E---Xf-
-?--T----o-Bo?oo---X---oT---o-oBE--------T|--o-B--|?MT----o--------|?-XT-E-?|---------E-----X---M----B--BM-------o--BBo-------B-oBB--o-MX-M-?---|---------E--|------??-----ET-EB--E------X---|-E--Bo--fE
-T-EoE|------T---??-----|---B---EX-?ME---X-oooXT-o--T-?------X-o--o--|--o-o---T---B--X--|--M-----B-o--?|M---?---T----X-|E-T-o--T--E?-|--B------E----?-|----M--MT-------TE---B-T?X----MB------B-----|?-fM
m--?-M----|-?--E---o-B?--|---?|-TM--?--|--------M--E-T-----ME?|--|----X--|---XE-E-----X----T-X--------o-EB----|E--|-oM-------B---E----?|T----B?-?M-|-B----oB---------T--?--|----M|?E------|X----M-----E-
XXXXXXXXXXXXXXXXXXXXXXXXXXXXXXXXXXXXXXXXXXXXXXXXXXXXXXXXXXXXXXXXXXXXXXXXXXXXXXXXXXXXXXXXXXXXXXXXXXXXXXXXXXXXXXXXXXXXXXXXXXXXXXXXXXXXXXXXXXXXXXXXXXXXXXXXXXXXXXXXXXXXXXXXXXXXXXXXXXXXXXXXXXXXXXXXXXXXXXXX
