--X|---B------B----XM-------------------TM-------B---------T--------------------T--------T---------B-----------?B-||-----T-M------E-----------?|--?-----?--------B---|BBB-----------M------------------T
--o----M-?--------M------M------o----E--?------E-?---------o----------M----X---------------------------------E----------|--------B---------------------X-E--o-?--o-----E----------?-------E-----M------o
----------TM--??-------------X------B?--B--------X------------------------------T---E----B?|B------E-----|----------oo------o------------------------------?-M----------------------X--------T-------T-X
-------X------------------E-?M---BT--------------?-----|----------------o----?------?-----o----B-------------------X----------M---------E---------|--------------------------T-----B----X-------?-?----T
--E----------T-------?--E?----------M-BX---------o-----?-------?-X--|--------------B------T---T----------MX-------||-o---T-----M-?----T-E----------------?-------------ET-o------------B--------M---M--X
------------o-E-B-------M----?--------T----M|------------M---MM----------?--------------X-o---EM-oM-----T--|-o------T-----T-XT-------MX----X----E--?--o-------X-------------------|--M----------E------M
---------M-----------X---B-----------E-E--------o-------?----------------------B-----B----M----------------------------------|----------------|----E-B------------|E----o------------|---M---------X---B
----B------|----o--?------M---M--B----------------o------o--|------X-X-----------X-----M-----------------o--------------------------M-------|---------------|-----E--MMMB--------B--E-----X-----------vM
--TXX-X-BE---|-X|---------M-M----X--|--BM---X-|-----o---B-BX-M--X?T|MM--X-----E----MEB--------E---M---T-M|E---X|-M-----T-----------|-o-?-|----X------T---Eo-?--o---T-----MM--T--E--?EB-||E--Eo-----|M-fM
-----|-----|-T?-XBB------M-----|-o--XTEBX-BX---M----o-T--E--?To--E--T--M----MMoo---o-------E-TM--X-X-E-o--------X--------X-E|--E---MX-XX?--BX--X--X-B--B-----B?o----BB-EX--|--E----------------|E?---MfT
---X-M--B-----------T-X-M-o---------B-B---o--?----T-o----|-|--T-------X--E----T-E-------B-?-MB-o|---?--?---|---E----oEM|T-?E-?B-X-?--E-E--B---B--ToM-XX-?XBX-?E----Eo----B---o?-------------B-o|-M---of?
-|-|-----M?----|?----M-?-|---X--EE-M-------MB--M-|----------MTo----|--------------T-oET-|E?-?-T-o-E-o-----B----MB--B---o--?-------------Eo-T|---X|?X-?---T-B-MX?-------||XT---?--------------BT--B----f-
--T--?-----X-oM|-M--|-ET-??-T---?--M------o-----?--||-|o---------BMMT----M??---X---E-M-XT|-XoT-E-|oE--T-T-MT----?-?XTo------XE--T-----|--oE-XX-B--X-EMo-?-M---o----T-XB--T-XB-X-----T--|T----o-?X-XB?Xfo
-----o--E--T-?X-T------T|----------TB--XM-------X-E---oo-?o---XE|o-M---E--XXToX---T-M---------M-----B-------M---M?|-XB-|-X|?-TE-|M-?--?-----B--T----------BE--|-X-T--M?--B----B?---?B---MM------------fM
m-?--oB-?B?-?|M------E----------------E----------Bo-T--TT--XT-X-T-----?---|-MT?--?B--XE--X-?-|E--XX||--X---XM||-X---?E-B-TT|o-MoB----E----BXMB|-----B----X---|E-B------oB--X----?-X--M----T---?-----MX-?
XXXXXXXXXXXXXXXXXXXXXXXXXXXXXXXXXXXXXXXXXXXXXXXXXXXXXXXXXXXXXXXXXXXXXXXXXXXXXXXXXXXXXXXXXXXXXXXXXXXXXXXXXXXXXXXXXXXXXXXXXXXXXXXXXXXXXXXXXXXXXXXXXXXXXXXXXXXXXXXXXXXXXXXXXXXXXXXXXXXXXXXXXXXXXXXXXXXXXXXX
