--------M-----------X-----o-M-E---------X---|-----?------------B-------E---B--?----------------?-------------X-|----------------ETT-------T--T---E-B------------------BM?------M-------B--|--M----------
----------------------o---TT----------X-------EE------------|----E---X|---T----o--?---X-------?-------o|--T--?--------T-o------------EoB---X------B-?----------BX-------------X-E---------------X------|
--o-----E--B-oB---?|---B-------Bo-----o---------------------M----------------|--------------B---?---E---------------B|---oE-----E-----------?------|E-?---M----M--o-----------X--------------o---T-E---?
--------o--------M-----E---M----T-?-----------?--|---o-------------|---------T-E----T----o------------------------------------------------|--X--TMB---o--o-TT---------E--------------M-M----E--o-------|
-----------?---?---T?---------------T---MB-?----------------?--X---------|---?----------T---------E-----|--------------B----------T--X----------?--------|----------T------M---------------|-----X?----E
----|---|-E--|---------B----------|---o---T--------------E----|--------M-----------o-------B------------M----M------o-|--------------M--?--------|?--?----M-----X-----X-X----------------------o--------
---EE-E----------------E-oT------T-E-----------T----X------X-------------X-------------------X-----------T---------------|-------------------T---|--------------M---------To----?X--E-----B-?T----E----B
-E-B------|EE-B-------------M----------------M------?--|-------------------T--------------T----------------------M------------X---T------E-----T------------------M---------?-------------------|BE--ov-
-----oX----?--E---|o---B-X-?X---BE--o----T-B--EEo-MTBEo?--?-o--|-T--------|o--B--?-E-X---------?---TBBT----T--o-B----B--T--?TX---XX||----X-o-o-----MM--|M-X------B--XX-|MEE--E------------o--E--o-X---fo
--X-T-T-oMMX-B--X-oETT-|--T---|E--EE-?E--o--o--------EX--E?--M|-|----E--|----|-T?----X---XB?-B?-----T---|-B--BB|T--|B--?--o-----?--B--M|----E|ET-----T--TB--oT-Mo----ME?--M--|E-E--MET--M-?XXB-X-E-TB?fM
-?-XMBBT-----E-o-BE-T------T-----B-E-TB--?X-----To--T----TE-TE?--o----M?-?-B----E-|--o-T--TT--T-E-----|-E-T----X-----M-?-|X-T--o--TB-?--?-----E-o---?E-T-T--EE-TM-E-|X---T-EMB----|-B--X-?X-o--|---BoXfM
-----|X-?EBT------|M--??--X-|-M?-X--XX-----M---T?o-TB---?--MB|B--|--|--?-----|-X-----?--B----E--|M---XE--X---T--|--|?B-----o-MM-M-|-oMX-|--T|-M-EX|-|--MXM---T----|-----E-T---B---X?T----?B-E-B-BM--T-fE
-B?B---X|---T|-----XE---B--X--------T-E-B---?--M?----X|---o------ME--X-M---B-M-o--------oo-----E-T-----|--T-TTo|--Bo?----M----M-M--M??-----|----EE|MM---?-o|----?-E?o-M-XBB-------M-T-o--|B-----T-T---f?
--X---EE--E--?-M---X------T----------?-BoB-E-----T----M----B-----T-?-----BE-B-T------o--o|-E--E--?--EXTBo--T--M-?---T|-----MT--?----?-T---E--ME-----M-E-E-o----------?----T---|---M-BB-M----M-EM-X-B--fo
m---|-?X--o------o-X--oTEMo--E-?-?-B-?-|oT--oX-------oE-----X--M--E?-X----ME-E--MMTo-o-------|-E--?T-M|-------|?-o------M?-TT-----o-B-??o-M-?B--M?--o-M-|--?--|M-TXE-To|B-M----------E-T|--------Eo--E?E
XXXXXXXXXXXXXXXXXXXXXXXXXXXXXXXXXXXXXXXXXXXXXXXXXXXXXXXXXXXXXXXXXXXXXXXXXXXXXXXXXXXXXXXXXXXXXXXXXXXXXXXXXXXXXXXXXXXXXXXXXXXXXXXXXXXXXXXXXXXXXXXXXXXXXXXXXXXXXXXXXXXXXXXXXXXXXXXXXXXXXXXXXXXXXXXXXXXXXXXX
