--------------------------------------------------------------------------------------------------------------------------------------------------------------------------------------------------------
--------------------------------------------------------------------------------------------------------------------------------------------------------------------------------------------------------
--------------------------------------------------------------------------------------------------------------------------------------------------------------------------------------------------------
---------------------------------------------------------------------------------------------------------B-----------------------------?--------------------------B-------------------------------------
--------------------------------------------------------------------------------------------------------------------------------------------------------------------------------------------------------
----?---------------------------------------------------------------------------------------------------------------------------------------------------------------------------------------------------
--------------------------------------------------------------------------------------------------------------------------------------------------------------------------------------------------------
-------------------------------------------------------------------------------------------------------------------------------------------------------------------------------------------------------v
----BBB------------------------------------------------------------------------------------------------------------------------------------------------------------------------------------------------f
-------------------------------------------------------------------------------------------------------------------------------------------------------------------------------------------------------f
-------------???------------------------------------------------------------------------------------------------------------------------------------------------------------------------------------X--f
-----------------------------------------------------------------------------------------------------------------------------------------------------------------------------B-------------------------f
--------------------------------------------------------------------------------------------B----------------------------------------------------------------------------------------------------------f
------------------------------------------------------------------------------------------------------------------------------------------------o----------------T-------------------------------------f
m-----E-------------------------------------------------------------------------------------------------------------------------------------------------E--------|----------------------------------E--X
XXXXXXXXXXXXXXXXXXXXXXXXXXXXXXXXXXXXXXXXXXXXXXXXXXXXXXXXXXXXXXXXXXXXXXXXXXXXXXXXXXXXXXXXXXXXXXXXXXXXXXXXXXXXXXXXXXXXXXXXXXXXXXXXXXXXXXXXXXXXXXX-XXXXXXXXXXXXXXXXX|XXXXXXXXXXXXXXXXXXXXXXXXXXXXXXXXXXXXXX
