-T-B----------------?---?----T----M-----|------?-o-o---------|T--X-----------?-----B---------X---------------?-?|--EE---?--X--o-o--o-----T-----M------------|------------?-----------o--------o|-------X
--B---------X-----------|--B?------o----E-E---------|-----T----------?---------T--?-----M-o-------o----T------------------------------?-X--------X--------?--o---------B--M---------------?-------E----T
--------------E------------------B---E----M--?------------E------|----?--M---o----XX----|--oT-MB-----------------|-----X--|------------X--------B-------------o--o--X------E---------o------------E----X
--T----------------M-----------o-M---?--T-----------------o-----?-----|-------X--M-|------?----------M-------------T---------------T---|----M------|---E-?--------E---|--------------------E--M------T-X
-------?----T---T------T---T-------?-------------B---XE---------E------E--?-------T----E---o-M--------T-----o-B----M--o------------E--B-------B---------B-----?----o---------------M-------o-------|T--B
---o---------------T-M--M-B------------B-|--M---B----------------M------------|-------M-ET-?-------M------TB------------------M----------E---||-----B-----EE-----------E----?-----XB--E----|---------M-M
---------------M-----X------------o-o--------EE----X--?------------------------|X-------------T-----?-------T----------------?----o---------X----------?--------?------oT-----------------?---------BX-M
--------------o-|-----?---E-----?---------------E-----B-----o-------o-X----T------------Mo-------M-----X--E-BM|----------X?--o---------------X----E?-----o--------E--?----------------------E------B--vX
----------o--To|-X----E-BE|---oEE-B--E-|-TB-M---XT---X-T--T-o--|--|B------Xo-----||---BB---?--|-X--E-oTT-TB-E---B-----------oo--o|--?-X-X--XT-------o----B--B-------?-o-?T-?-E----------B-----TE-??-??fX
---B----E-?--X----X--------|-M-M-------|o-M--??-|---|Bo----?-----X-o--o-EBoE?EE---o?------o-o-T?---T|--X--------MM-?---|---o-||X--o-X---B----|M-|M--X-----E-|-X?-X-----Bo--o-------X-----B--?X-B--|B--fB
-----X--oo--|--BX--TE-T-X--M------?ToM|BB---?------T-----T-o-o-T-|-----E--EX--T?|--Xo?BT--?--E---TT-X-?--X----o-o-M|o--E--?---o--TX---|--M-TTME-M---T|B------BX-----To--T?MM-o--o?------------o-------fT
------X----o-T--M-T-------?--M?E------XTB--X---|--o----B-----E-E--X-|-B----B-E?o---B----------o------M--M-?--?---M----?-B|--o-------o-X-TXX-?--|M---B---E---BM----oB----?--o--MoX--|-o---B-T------TM?TfB
--|--?-M---X-o--?-B----o--o---X?X-----|----E-M--M------?-X----------M----oB---B|-TT----X----o--X---MoBMT-?-M----o--oE-MEB?---M---o-X---o-B--E-B---M-|----T-TB--M-o--X-T--XMT--?--ET------XM----o??-T-Ef?
--E----M-E?o-?X-----|T-o-------------|--Bo?B---X-?-B-E-?-BE||?-X---T?B|--XET-----o----|-|?--EoT-----X---?--M---T---X?EX------B-----B-X-M----T---T-B-BE--|----E----B-T-|------Mo-|---M?-T--B--T|---|---fM
mT-----M-----TB-o-------B------B-X--------T----?o---X----M--?------oE-------X----|-|B--B-Eo--E--T------T-----|o--o-Eo-M--o?--X-MEB--XoM|--Xo|--|o-o-----|---|---M-o-X--|XEBB-----o-----------?---X-|?--B
XXXXXXXXXXXXXXXXXXXXXXXXXXXXXXXXXXXXXXXXXXXXXXXXXXXXXXXXXXXXXXXXXXXXXXXXXXXXXXXXXXXXXXXXXXXXXXXXXXXXXXXXXXXXXXXXXXXXXXXXXXXXXXXXXXXXXXXXXXXXXXXXXXXXXXXXXXXXXXXXXXXXXXXXXXXXXXXXXXXXXXXXXXXXXXXXXXXXXXXX
