----------------M----X---|----------------M-----|-------------------B------------oBE-----------B-M------M-----------------------------------E----X-----------------------M-X--B--------T--?------------|
--------T---T--T---M-------------E--E---T-------------|------T--|-T----T--?--------?-T--E----o---E-B----o----------M---------------B-------|----------MT---------------X--------------|-------?M-T-----M
-----------o-E------------o---------B-T-------T---B||--B----------X----------------------------|--T-E--o----------E---------T---------B-M-------------o--------------------------?--T------?-----B--B---
--------?-------------E-----?---------------?---------------|----------B-|-------------E----T------X---X-?o--?----B-B-T------------------X-|---B-----?-?---|--------------------|------B-TX?----o--B---X
----------?---B?----------------|---?-------------------------------E------E--------------EX-------------------------------B?M-----X-------------------|---------M-------o--------o----M--E------------T
-----T---------E-o--|-T-------|---T|T--------o---------------------E-------B---|-T--------------------|-T--------M---M---X-----E-----?E--------|-------------------B--------B-?---------X|M------------T
--------------T-----M-------?----------------?-----------B-----?--------------M-?--------T-M--------M--BM-M----B--------M-------X--------T-----M---------E---------|-|------------E--------------------|
--T--------B------------------------------------M-------------oM--------------------?TT-T-----?-----------------B-------ME------------|-----------------T--M------?--B--------------?------E--------X-vM
--EBEo-BM----TM--TXTX--o-X?T--MB-MM-?-X-T-T?------X---T---|-T-M--T------?TB-------|-X-T--B-X---|--E-------X-Xo---------|------X|---?---------|-------oM?|-X?----E----o||--X|BB-oX--T----|B----oT---o--fo
----||oTX----o--?--T-B-M-E-T--?--XEo-MT---|------M------MX-X--o---T?T---X------?|M---T-XT|--?oB-?-XB----M-ETM-M?|o----E---M-M|B------?M-?-?-B---|M-?-E----T----X--?---XB-B-B--X-----|------M---X-B---Xfo
-|--oXB--T-----------XBo-E------?-o----|-E---||MM-?------E-X---o|-----?-B------T------X-T?----EX------E----B?-----X---?T----B-------o-B----T---oTT|T??-|oo---M-B---M---|Xo-B--?-|B-o--X--E-XM|MoB-----f|
-?---TT----|---B|o--ooBo---B--E-T------oE-----?M--EM---oX|-o----|----E-|---X--TM--|--T|To-?M------E---?T-|----------?X--|X-----o-|-o------------o-T----BM-X--X--B-B----|?-XX-|-----X-----o-MX-Xo-----BfB
-T-Mo|---?-----X--o--M?---X--o-BM-E---E---T---?-M-o-----|---M|--E|-?--B------T-|---?-B-?-ETE--?-------BE--M-o|B----?B-o---M--?-|---E-----MMT-|-?---||--?----|----?------XX---o----------B----M--Bo----f?
-|-TXT-----T|-E--M--XE-BE--B-X-|-E-------Bo-o-----E------------|oB-----?-o?---|-E--M---E-T--o-T-E|-----|---B------XM-----T-----BXXB---X||---?--XM-B-M--B-X---|XX---B--?---?----oEo-B--XBB---?----ETE--fX
mBE-BX----T?EBT---EMBB---E----Xo---------o--E----XBB-------To--T-B-T----MEM--To----|-TB-B|||-----MXE-EE---oT------T|--E--M---To-E----------X-----|-B?--|--Bo----?--?-||----o-B------T------?E--E--?----B
XXXXXXXXXXXXXXXXXXXXXXXXXXXXXXXXXXXXXXXXXXXXXXXXXXXXXXXXXXXXXXXXXXXXXXXXXXXXXXXXXXXXXXXXXXXXXXXXXXXXXXXXXXXXXXXXXXXXXXXXXXXXXXXXXXXXXXXXXXXXXXXXXXXXXXXXXXXXXXXXXXXXXXXXXXXXXXXXXXXXXXXXXXXXXXXXXXXXXXXX
