---------o----T--------------B-----T-?---E-o-|--------M-----------E?EM?----------|----------------T-o-|----BM-------M--X-----------------------o-----XM--------------T----E-------?---------|-----------
----T-------------------M--|--------------------|o-----------M-o------?---------------B----?---?o-o------o--------------|T---------B---------E--------------T?------------B----|-------?----------------
--------o--E-T---X----B--EX--|--M--|-------------------B---?-T--E---M--Mo--M-------?--------------------------------E------------------E-----B----------?---?---E--X-----B-----T--o--E-----------------?
----------M--------o---------------T-------------M-M-XX|TE---E-----------T?-------------o--T---------T-----o-?----?-----------------------M--o---X-------E------?--------------------------------------T
-----?----------T-E------------?---------------X-------------X----X----------M-------?---------------ooX--------------o----------------T-----------E---------X------------|X-----B---EE-----------|----o
----------|------E-----X----------o---B----X--B-------E-E-|----------XE-------T------------------M----T----------------T-X-----------------------X----------------------oMBE------B---E-------------?M-E
-|----------|-----------?---------M?-?-E-o-T-----------------------------T----B--|-----B--------TM--------------M----------|---------E-E----E|--o------Mo------------o----------|-----------EE-----o---o
--------M-----o----o-----------M---------------M---------B-BE------------BTB---------?------------|------------------------------?|------------------M-------?-T?----B----------------------X--o------vM
---BE-E|--XE---X-E-MB-o--??-----EM-----?-------|--oXB---|---E-o--oB---|M-MEo-B?B---E-----|B---ETo-------|T-E------Bo-?-M----T?ToE-M---X-E--M---BE-o--X-X--ME----------TB-??X-ME--T--T-Mo----X?--|---M|fB
-------B-EXTB-o-|X------X--?M?-T-X|-------E----|--------M-?----BX------o??--B|--T-|B---|T-----------o--|o----E-M|----|-|-|--o-BBT--E-o-X---T----BE--?X---?-----oo?------T?--|-X-ToX---|BT-?-|---XE-ooBfT
-----T-EB--M-?-o----T-||M-?----o----XE-E-X----T---EM-?---EM-----X---T--T--T|---oT|----------o-------M-----M---BB---------o-|-|-M---?--|---oo-T---T-E--o---EB-T-|-B-B-|----M?|--M---B---T--oE|--MXET--Xf-
-o-ETo--E----T-B-M-XMM---?|oB---E-----?B-MTM-T----BT----|--X-XE-----EB--XB-----?---o-|----o-B---o----------E--BX-?-MB--M-B-T-X-----TB?T-?-T-?|-----E-BB-------X-----T---X-X-----M-Mo?--TBB--T---XB---Bf|
--B----M--T-----|BTBM----o|T------X--B-MBE------EX-|-E-B|X--------B--B-MT-o-B|?--oo----E-B-|?-?X|?-----B------------MT---T?-E---|E-M------TTo?--M?-X--?-o--E-|------|-o-oTMM---B--|-----|-B--?ETEB----f-
-|?o|XE-?-----o--T?-E-?----o--T---|-M---E----E---o----M-?----EEM--X--M-----E-?-T-X-Moo--BEX|-BXE--M--X-?MT--ME?oXM--E-X----E--|X?M--M---??B-MB---o----oB-------|-----o--o--T-----BBBM-|--TT--M-EXM----f|
mT-B-X--MB-------|----|--o-o-T--------o--T-----|-----Mo--B--?----T----X--|-oT---EE-----|XX?------?-o---T---B--o--oB-T-E-|--MXoX-|T|-----X-MT?|-T|-------X---E--------------Bo--|---T--B-?M--?B-||----E??
XXXXXXXXXXXXXXXXXXXXXXXXXXXXXXXXXXXXXXXXXXXXXXXXXXXXXXXXXXXXXXXXXXXXXXXXXXXXXXXXXXXXXXXXXXXXXXXXXXXXXXXXXXXXXXXXXXXXXXXXXXXXXXXXXXXXXXXXXXXXXXXXXXXXXXXXXXXXXXXXXXXXXXXXXXXXXXXXXXXXXXXXXXXXXXXXXXXXXXXX
