--------------------------------------------------------------------------------B----------------------------------------------------------------o------------------------------------------------------
--------------------------------------------------------B---?----------------------------?--------------------------------------------------------------------------------------------------------------
----------------------------------------------------------------B-----------o---------------------------------------------------------------------------M----------------X--------------B----------X----
-----------------------------XXXXXXX--------------M----------------------------------------------------------------------------?----------------------------------------------------------------------?-
---------------------------------X-----------------------------------------------------------?----------------------------------------------------------------------------------?-----------------------
------------------------------------------------------------------------X---???------------------------------------------------------------------------------------------------B--------T----X----------
-------------------------T--------------------------T----T-------------XX-------------------------------------------------------T-----------------------------------?-------------------|---XX----------
-------------------------|--------------------------|----|------------XXX------M-BBB--------------------------------------------|---------------------????????--------------------------|--XXX---------v
-------------------------|------------X-------------|----|-----------XXXX---------------------------------------------o---------|-------------------------------BBB---------------------|-XXXX---------f
-------X-----------------|------------XX------------|----|----------XXXXX-------------------------------------------------?-----|---------------------X------------------B--------------|XXXXX---------f
-------XX----------------|------------XXX-----------|----|---------XXXXXX------------------------------------------T------------|-------B-----------------------------------------------|XXXXX---------f
-------XXX---M-------?---|------------XXXX----------|----|--------XXXXXXX--B------------T--------------------------|-M---?------|------------------------------------------------------X|XXXXX---------f
-------XXXX--------------|------------XXXXX-----T---|----|-------XXXXXXXX---------------|---------------X-------T--|------------|-------T--------------B-----------o------------------XX|XXXXX---------f
-------XXXXX-------------|------------XXXXXX----|---|----|------XXXXXXXXXX--------------|--------------XX-------|-T|---------o--|-------|--------------------------------------------XXX|XXXXX---------f
m------XXXXXX------------|------------XXXXXXX---|---|----|-----XXXXXXXXXXX----------E---|-----E------EXXX-----E-|-||------------|---E---|----------B------E---E-E------------o------XXXX|XXXXX---------X
XXXXXXXXXXXXXXX------XXXX|-------XXXXXXXXXXXXXXX|XX-|--XX|XXXXXXXXXXXXXXXXXXXXXXXXXXXXXX|XXXX?????XXXXXXXX----XX|X||XXXXXXXXXXXX|oXXXXXX|XXXXXXXXXXXXXXXXXXX-----XXXXXXXXXXXXXXXXXXXXXXX|XXXXX--XXXXXXXX
