--------M----------?-------MT-?-M----|-------------------------B-M----BX--o---------|---?-o----|-B---M-----XB-------X------------------X---------M-----E---X-----------------EM------TX-----------?----T
-------T-----?-ET--?o---------?-----------X------M----E-------?-------X--M-------B-----?---M----------T---|----------M--TB-------MT---X------------------T------|------o-X------B---------?----M---Eo--o
---E------EE--------M---|----------------M----------------E--T--?----X-----?-M-------o-|---?--T----T|------B--T----------------Eo------E-------M-------o----|-----M--------------E----B-------oX---E---?
--------------------------B-------T-----X------|------o-------T---------------T?------------EM-------TB-----X--E----o--o---MB---------------------B-o---------T-------------|---o----B?----------------|
----------------------------?---o-o--------M---------|-?-|-----------EB--B|-E---oX--------------------------------------------o-----------------------------------------?ME-------E--------------------o
----------B------|-----------|-----T----B--------|----B----------------------X------------X--T-|----M---------T-----------T----M--------B-------|E-o--------M----M--E---------|-------------X---B----B-M
---MB-----?MM--|------?----------T--------------------B-----------X|-----M-T---------o---------------T------------|T---------X-------E------------------------B---E-----------X----T-B-----------------?
----o|-T----------X-E--------------o--o-------M--X----o----|-------M---------X--X--B------o--------T------------------------------|------o---X---B---------X---E-------?-----oE-------?B-E-?---o---?--v?
---M--M--TEXo-----Bo-E---M--?------?EE-B--M-------M-o-T--o--XB---BE---|EB---|T-XXB-E--MT|X----o??--T---------B-|---X---B--M-B-TT--?|-X--BT--?---oo---E-|--XTT-T----------|--o|----B|B--B-----?-BT---B-fB
--M--M----oM?----B---B------E|-E-oEX-oB-M|B------o-X--X---------BB-?--|---EMM-MTo-o-------TT--XM--B----X-Bo-To---B|oo---o-MT---o------B-?-X-E--BB--M-M-?--X|E-TM--o--------E-E-------oTM|-E--T|oT-----f-
-|--B?-E--B--?-T-B---o|?o------B--T-E?-M-M--BM?EX------?Xo-M||E----|X-Eo---o-----o----?----BE---BM---o|E--|X-------B--?---?----ToT-B-T|--TE----------T--E-----B----M-ooX-|--M--T--------T-|E--|-?-----f?
--B-MTB--Mo-E----|--XT?|-?----?---TE-----oXMX-T---M-EoXX-oM|E--E------------T-M----?-T-X----B------ME-oB-TE-T-?-T-??TB---B--TM---o-oTTEEB---B-----?-o-----|X--oM-|T-BB-?--|B---TMM--B-M--------BT--X--f|
----?B?-T-E----B-o|---?-o-----oB--T-o-TE|---T-----BB-EM?-oo---|--o------o----------T--T---o?X----?-M-BX-X--M---X------?X?X---X--BXo-TT-?-|----X-?-----E|-B|-o-EE----B---o---M-T?------?M-----XM-?--?B-fB
-------o-BE?T---B--TM-M--o-oME-?---o-B---M-B-M-B|-----E--B----X---X---?XXXT-EEM-B----X---T-T-X|--M-oB--MMB-M---BM--BT--|----------MX--T-?oo-o-?-XT?-|--EBM--X|--T--X-----E----E-----o------|--------|Xf-
m|-EX?----X-T-o-X-E--E----?E-X------MX---X--TM?--M--B-o--E----o----BMT--M-o-o----o|--------M??--|-To-MMB--Mo|T-B--M--------BT---?---X--oo----??-X--?-----B-M---MT--??-|-XMX-|-?---?X-B-----o-------|--Bo
XXXXXXXXXXXXXXXXXXXXXXXXXXXXXXXXXXXXXXXXXXXXXXXXXXXXXXXXXXXXXXXXXXXXXXXXXXXXXXXXXXXXXXXXXXXXXXXXXXXXXXXXXXXXXXXXXXXXXXXXXXXXXXXXXXXXXXXXXXXXXXXXXXXXXXXXXXXXXXXXXXXXXXXXXXXXXXXXXXXXXXXXXXXXXXXXXXXXXXXX
