-M-------MB------------T------o--T---------B-------B-------oM--|----------M--------------XB-T------B------------T---B--Mo----------M------?--oX-B-o--?-o--X--|------E-------o-?---------B|-------|-----M
-o----?------------T------------TEB------------------------------|-EB----------T---o---------------X--M------E------------|-----?---X-------B-----------------E----------o------|-----------X----------?
--?----X-----------------------X------T-------------------??--o-------|oX--------E----------------------o-----B---------------------------B------?-------------------TB-EBT-----------------------B----E
-----------X------o|oB----------M------|----------------------?B----------?---------?--|-E-----|------?------------------E----X-E-?-------T---M---M----------X-------X----------B---?----------------E-B
------------------------------M------------------E---ET--------------|X-B----M-------|------?--M-----X--X--------------X--X------E-T---E-------------|--------B-----------X-------M-E--?---------T-----T
-o---|o----------|---|-------B-----?---M---------E-----X---------T----------o-----------------B-----o-To--?----------M------------E-------------M--------------E-------Xo----------------B-------------X
-------M-------------?---------|B--X-?---B--------------------B-------------?-----M-TBM?M-----------------T-------Bo-E--|-----X--E---Eo-----B--|-o---T--------|-----E--------------|----|-T--------B---M
-M-B----E---|----------E-B--o------X--XE----T----o-BT------------o------Bo-------X---------?--------------------------------------------E------o---B--M----o---------EM--X---B--M--------------o------v-
----|-o|-MM--M-T--M-X-X--?-E--X--|B?---oTX-?-oET--??-?E?------E|---B-B--B--?--?------Mo|X---X--|------|-?X--T---E----M?--M|M?--------T-METE--B--X-E-------TTM-?T--------------X-E--ME-|-|----X-M?-----fM
--M----B----o-X?|-o------o--X-------o-|T---------oTT-EE---EB--X-----ME--M-T----M------X-----Mo-o--ET-TX-E---E-o----X|TBE----------T-XX-o-E-B--B-BX-?--------|----------?-?-B--|---M?------EEB--X-To-M|fE
---T-|?-T--M--X-E--o---E|-----?-BE-B----|M-E-TB---MM--E----------------BTM--TXM-X-X---o---E-------T-E|MB---T--TX-T----------EM--M---B-|-?--M-|?-?-EB---M---B--|-?-XETX---oEX-o--?--------T--M-MM-X--X|f?
-||o|-B--X--X-X------M---|--E-----E--o-----T----------BEXB?----E-T------M---------EE-----E----B--o---EM-?-?----B-?B----o----?--o--oM--?-BT-|?------EM--XoX--XMM-T-?E-X|?-o--X--o--------BM-E-B-|B--M-ofB
-T----o------E--T----|o-|B-----MB---T-T-|----EXE---------B-EE--X-T--o---B-|--X----o-T-?-X-------E---MM----T---B---TE-MoX--oM-oT-----E-B?-B?-o-?--X----|---X|--M---E-oB---|-|-------E--M------XX--E----fE
----E--------T--o--EB|-|o|-?-T---TB-|-E----oEo-?-----E-M--?------XX--|-M|----T----B-oB-?-?---|-|-?----B---o--B-E--o-----MM-oB---M-?----M-BM-T--Mo-E----X-------Mo-T--o-?--|----T-------M-----MEMT---o-fo
m---XB----E---X?-------T-T-T--X--E------|Xo---X-E----------------BE|ToM-X--XX------o-X-o----B-E----X?-----B---M|----BB-E--T--X-oX?--X---|E----???B-----EB----M-M----TE-BB--E----X--------E-----MMEB---?|
XXXXXXXXXXXXXXXXXXXXXXXXXXXXXXXXXXXXXXXXXXXXXXXXXXXXXXXXXXXXXXXXXXXXXXXXXXXXXXXXXXXXXXXXXXXXXXXXXXXXXXXXXXXXXXXXXXXXXXXXXXXXXXXXXXXXXXXXXXXXXXXXXXXXXXXXXXXXXXXXXXXXXXXXXXXXXXXXXXXXXXXXXXXXXXXXXXXXXXXX
