--------------------------------------------------------------------------------------------------------------------------------------------------------------------------------------------------------
--B-----------------------------------------------------------------------------------------------------------------------------------------------------------------------------------------------------
--------------------------------------------------------------------------------------------------------------------------------------------------------------------------------------------------------
------------------------------------------T-------------------------------------------------------------------------------------------------------------------------------------------------------------
----T----------------------??????---------|-------------------------------------------------------------------------------------------------------------------------------------------------------------
----|-------------------------------------|-------------------------------------------------------------------------------------------------------------------------------------------------------------
----|-------------------------------------|---------------------------------------------------------------------------------------------------------------XXX-------------------------------------------
----|-?-----------------------------------|--------------------------------------------------------------------------??--------------------------------------------------------------------------------v
----|?------------------------------------|------------------------------------------------------------------------------------------------------------------------------------------------------------f
----|-------------------------------------|------------------------------------------------------------------------------------------------------------------------------------------------------------f
----|-------------------------------------|---------------------M-------------------------------------X-------------T----------------------------------------------------------------------------------f
----|-------------------------------------|-----------------------------------------------------------XX------------|----------------------------------------------------------------------------------f
----|--------o----------------------------|-----------------------------------------------------------XXX-----------|----------------------------------------------------------------------------------f
----|X------------------------------------|-----------------------------------------------------------XXXX----X-----|----------------------------------------------------------------------------------f
m--E|X------------------------------------|-----------------------------------------------------------XXXXX---XX----|----------------------------------------------------------------------------------X
XXXX|XXXXXXXXXXXXXXXXXXXXXXXXXXXXXXXXXXXXX|XXXXXXXXXXXXXXXXXXXXXXXXXXXXXXXXXXXXXXXXXXXXXXXXXXXXXXXXXXXXXXXXXXXXXXXXX|XXXXXXXXXXXXXXXXXXXXXXXXXXXXXXXXXXXXXXXXXXXXXXXXXXXXXXXXXXXXXXXXXXXXXXXXXXXXXXXXXXX
