----------M--------E------------------------|----------M--------------|----o--------------------------------oM--X-|-T-----M----------T----|---|--ET----X------------------X-?-----o--X-o------------?--|
----B-E------?--|-X---------|---T----M--T---|--------?----EB-------?---------------M--T---------M-----------|----------X---------------------X---------------o---T--E--------|----|----EB?-------T--?--T
-----------E---------|B------B-----------T-XT--M----------o---|----?X-----B--E-M----?-----------------X-----M-M---B------T----T--E--M-----------------------Bo--o-?--------------E--o|---E-------------X
-X-M----------------------------M-----|-?--M--MM----?----o--?------M----B-o-X-|-------M--B-M--B-----------------|--------------|--o--B----B----T---------?---E-------?------------------------T-----|--|
--MM----?---------------X---------X------T-o--------T--------|----o---------o-----X-----E----B--------T----o--------------------------------X-o--------M-------------M-----------E--EE-----|------------
--------------E----B----B----------------------E--------T--------------------oM-----------------BX-----T-M-----X-?B---------------T--?B----X--E--------------o------T-----------o-|-M?------?---M---o---
---E--------------------------|----E---------|-X-----------M------------X-------X----BB--|-----|----T------|-XBX--TTo-----BB-----?--B-----------o-M------|-----B-------M---------------------------Mo--T
--o-X-------------------------X-----o---?----T---------------o---B--------|----M------------------------M---------|o------o---B---|-------?---------------------T-E----------|-M----E-----------------v?
--E----BB---E-|---M------E----M?--?B---MTEo--TXXB-----B-E-X?-------|-|M-|X--ooM-----M--T-----oE-TBB-B--T-------o-M-----------T------------o-?M-X-|M------M----XT?--|-TM----oXX|T---E--T---M--T|--E--TXfE
------o?------|----------X--?oE----||X-o-ME-E---o----M?-----|------E|--X------|-?-E-XT----M-M--MoB---X---------------?-----o---?Mo------M----------T--E------M---BT|--E-----ET--o?E-B-T---?--M---oM---fE
-o---MEE-----B---|E----o-|-|-T-----B-XMB-BX-B---MoXM-----B---|E-----o----?o--|E-M---B-M--o-?--?-B-EM-|-------B--X----T-o-----o-X-EM---o-----o-E----oX-X----?--|X-----MB---XTB---X--o---M?T-----o?|-||TfX
-T---MXX-|-EoM-|-MEM--T---EX-?---M-|-Xo---|?-----------Mo-o---|--|---------M----------M---M-X-T---?-?-E-o-------------|M-------M--|---T--E-MBT-o-|B--T------B-----|?------|-X--B-----M-----B?B---MT---fX
-B-B?-----MX-M--------B--TEo-M-----?---B-----X----o-o-oT-X|-B----|--ET---oXM-?-----E----------E-----|?-oEBMT---TTBT|?----B--X--Mo|-------Eo?--o?--B------B----BB-------o--?--XEo-----|-T--EM--T-E-?E--f-
-?-E-------|--o-Bo?---?---Mo--o?|----o----E-E----------MT-----B----B--T--EX------o----TT--|?T-B|-E-T-?B--|-T------|--X---M------o-||-------|----EM-----T-BX-X|----M--X--|-M---------|EX------X--------fM
m----X-T-TE-B----|BB------B------E-X--X-?---X----X|--MooM--MoXo-ME-M-|--------?E|---X-?--|-E?-oX-|--E--Mo|----o-EX----------M--XB---TEo-?-------o-X-X---?-------||o----TE-o--M-o---M-B---|-----?------TT
XXXXXXXXXXXXXXXXXXXXXXXXXXXXXXXXXXXXXXXXXXXXXXXXXXXXXXXXXXXXXXXXXXXXXXXXXXXXXXXXXXXXXXXXXXXXXXXXXXXXXXXXXXXXXXXXXXXXXXXXXXXXXXXXXXXXXXXXXXXXXXXXXXXXXXXXXXXXXXXXXXXXXXXXXXXXXXXXXXXXXXXXXXXXXXXXXXXXXXXX
