--------------------------------------------------------------------------------------------------------------------------------------------------------------------------------------------------------
--------------------------------------------------------------------------------------------------------------------------------------------------------------------------------------------------------
--------------------------------------------------------------------------------------------------------------------------------------------------------------------------------------------------------
---------------------------------------???---------------------------------------------------------------B-----------------------------?--------------------------B-------------------------------------
--------------------------------------------------------------------------------------------------------------------------------------------------------------------------------------------------------
-----------------------------------------------------------------------------------------------------------------------------------------------------T--------------------------------------------------
-----------------------------------------------------------------------------------------------------------------------------------------------------|--------------------------------------------------
------------------------------o-------------------------------------------------------------o--------------------------------------------------------|-------------------------------------------------v
-----------------------------------------------------------------------------------------------------------------------------------------------------|-------------------------------------------------f
-----------------------------------------------------------------------------------------------------------------------------------------------------|-------------------------------------------------f
-----------------------------------------------------------------------------------------------------------------------------------------------------|----------------------------------------------X--f
-----------------------------------------------------------------------------------------------------------------------------------------------------|-----------------------B-------------------------f
--------------------------------------------------------------------------------------------B--------------------------------------------------------|-------------------------------------------------f
------------------------------------------------------------------------------------------------------------------------------------------------o----|-----------T-------------------------------------f
m-------------E----------------------------M---------------------------------------------------------------------------------------------------------|--E--------|----------------------------------E--X
XXXXXXXXXXXXXXXXXXXXXXXXXXXXXXXXXXXXXXXXXXXXXXXXXXXXXXXXXXXXoXXXXXXXXXXXXXXXXXXXXXXXXXXXXXXBBBBBBBBXXXXXXXXXXXXXXXXXXXXXXXXXXXXXXXXXXXXXXXXXXXX-XXXXX|XXXXXXXXXXX|XXXXXXXXXXXXXXXXXXXXXXXXXXXXXXXXXXXXXX
