-------M------------------T------B---------T-------------?-X---X--------X-?--------------------------E-----o--X------|--o-??-E-?----?-------------o------o----B-B---o--B----|-----------ME---------T---o
---|B------|-------------------X-------M-----E-----------------M--E---o-------B---------T-----o-E-----?---M----TX-------------E?------T-?------M-XBT--T--M-?--------------?--E-----------?M---o---T----E
------?--------o-X----X---E--|---------E|-?T------------------------------|-T---|----------------o----------------------E-------B-X-----------M-----------M---|-------------M----o---B-----E-----------o
--------M------T----B--------------------T---------X---?oM-E--?-------------|------------------T--E---------?--------------------------T---------o-----------T----------X-----E--B-------------MX--?---T
----o--------------------o-----------T----?-----------------o---M---X------------TM------M--------XX---------------|---------------?-------o----------o-----E-|-----------T---------|--M--T-----T------M
----X|--------------X--------E---------------------M-o-------------|-----T----T------|---X-B-------------------T-------X-o-----------------?--------?-|?---------X---------E----|----T------------------
----|---o---|-?-B-----?--X---------o----|----?B-------o---|--------BX-B---------B----|oE---X----------------Bo-----------|---M---------E----------?---------T--------------oM?Bo-B---------T-----------?
--------------X--------------|?T-------------To------o------------------------X------------------|--T-------M--X---o--|---------M--------X-----E---|-------------E-----o--M-------------o---o---------vE
-T--------------------o---?B--|----EB-M-B--BB-|B|-B----X----?----|-----E---B-B-oME-|-----XX---T-E-E-MM-B---E---o-T-B--oM----X--|---o?---TXBB|---T?----T-E|-oT----XB-|M-M--B-M-o-X-------T-B--TX?----M-f-
--------TX?o-|---M-X-o-B-?||---BT-EM--B---E-------oT--------oB-M-MX--|-T--?-oX-|-oXM-M-|M-|X--TMM--E----?----X-ET------ME?-?X-----T-------M-B-BX-X--?X--E--o--B--M------T-|------------B----??----|M|EfE
-X-XM---ETBX---?B--o-?X--?-|--------B-?B-oX?BM---B|-----T------E-|--?---?--?-------|------M-X-----TB---|-oME---o-MoT-|To--?-----MEM--o-----|MX--?---B-M--B-BE-?XT--T|EXXo-E--B---T-T-X-BB|MB---M-X-B-of-
----ETT-B---oX--M-----MXTE--X--?-EBE-B-TB----T-----XT?XB--|--E---B-?-?---T-B-|----M-----?B---B|M--?-E--X----|-M-B----o-o-X-B-B-MM|B-----------?o-MX?BX--oX---B--BM-oTE--BB----Mo--E-E--|-TT-|---|-----fo
---?----------E-E------X------T--B-T-----o--MB---o|--B----B----------X---EB--M--M--X---TB-?-T-----M-|-B--XX-B?-B-----o?-?M-----?-oX-T---M?-----?E??E----X--E-M-----M-------M-M-|-|----X--T--?-B---|-X-fE
--M------M------------------T?-M-M----------------ET--o---EBXM|---X-------E-o---B-M-B----B----o----o--|--?----BB---oB---|M--------X-X--M--B-|---E-?--o----------XT------T--T-XXEo--B---oX|--E--E-T-o-Ef-
m?-MT--?-------M---B----X--M-|T-oo---?M?--|?-?B?---T---T--B-XB----B-B?--B--Bo------B--|--M-T?--o-o-E-o?--B----B---M?-------|-BT---E-?-E-M--o-?-o?X--Eo------MB-----X-----M----T--T-B-T--B--?BB---X----EB
XXXXXXXXXXXXXXXXXXXXXXXXXXXXXXXXXXXXXXXXXXXXXXXXXXXXXXXXXXXXXXXXXXXXXXXXXXXXXXXXXXXXXXXXXXXXXXXXXXXXXXXXXXXXXXXXXXXXXXXXXXXXXXXXXXXXXXXXXXXXXXXXXXXXXXXXXXXXXXXXXXXXXXXXXXXXXXXXXXXXXXXXXXXXXXXXXXXXXXXX
