--------------------------------------------------------------------------------------------------------------------------------------------------------------------------------------------------------
------------------------------B------------------------------------------------------------------------------------------------------------------o--------B---------------------------------------------
--------------------------------------------------------------------------------------------------------------------------------------------------------------------------------------------------------
--------------------------------------------------------------?-----------------------------------------------------------------------------------------------------------------------------------------
-------------------------------------------------------------------------------------------------------------------------------------------------------------------------------T------------------------
------------------------------------------------------------------------------------M------------------------------------------------------------------------------------------|------------------------
-------------M----X------------------------------------------------------------------------------------------------------------------------------------------------------------|------------------------
-----------------XX------------------------------------------------------------------------------------------------------------------------------------------------------------|-----------------T-----v
--T-------------XXX-------M----------------------------------------------------------------------------------------------------------------------------------------------------|-----------------|-----f
--|------------XXXX--------T-------------------------------------------------------------------------------------o---------M---------------------------------------------------|-----------------|-----f
--|-----------XXXXX--------|---------------------------------------------------------------------------------------------------------------------------------------------------|-----------------|--T--f
--|----------XXXXXX----T---|---------------------------------------------------------------------------------------------------------------------------------------------------|-----------------|--|--f
--|---------XXXXXXX----|T--|---------------------------------------------------------------------------------------------------------------------------------------------------|-----------------|--|--f
--|--------XXXXXXXX----||--|---------------------------------------------------------------------------------------------------------------------------------------------------|-----------------|--|--f
m-|------XXXXXXXXXX----||--|--------E------E-----------------------------------------------------------------------------------------------------------------------------------|-----------------|--|--X
XX|XXXXXXXXXXXXXXXXXXXX||XX|XXXXXXXXXXXXXXXXXXXXXXXXXXXXXXXXXXXXXXXXXXXXXXXXXXXXXXXXXXXXXXXXXXXXXXXXXXXXXXXXXXXXXXXXXXXXXXXXXXXXXXXXXXXXXXXXXXXXXXXXXXXXXXXXXXXXXXXXXXXXXXXXXXX|XXXXXXXXXXXXXXXXX|XX|XXX
