--------------------------------------------------------------------------------------X----------------------------------------------------------------------??-----------------------------------------
--------o---------------------------------------------------------------------------------B----------------------------------------------?--------------------------------------------------------------
----------------------????--------------------------------------------------------------------------------------------------------------------------------------------------BBB----------------o--------
------------------------B------------------------------------------------------------------------o---------------------------------------------------------------T--------------------------------------
-------------------------------------------------------------B-X-------------?---------------------X-----------T--o-----------------------o-------------T-T------|--------------------------------------
---------------------------------------------------------------------------------------------------------------|-------------T---------T----------------|-|------|--------------------------------------
--------------?--------------------B---------------------------------------------------------------------------|-------------|-------T-|----------------|-|------|----------------?---------------------
-----------------------------------------------------------B---------------------------------------------------|-------------|--XXXXX|X|----------------|-|------|-----------T-------------------------v
-----------------XXXXXX----------------------------------------------------------------------------------------|-------------|-------|-|----------------|-|------|-----------|-------------------------f
---------------X-----------------------------T-------------o-------TXX-----------------------------------------|-------X-----|----M--|-|----------------|-|------|-----BBBB--|------------------------Xf
--------------XX----------T------------------|---o-----------------|--------------------------------XXXXXX-----|------XX??B?-|-------|-|---------------B|-|------|-----------|-------------------M-----f
-------------XXX-X--------|--????????--------|----------XX---------|------------X------------------------------|-----XXX-----|-------|-|----------------|-|------|--BBBBBBBB-|------T------------------f
---B--------XXXX-TX-------|------------------|---------------------|------X----XX------------------------------|----XXXX-----|-------|-|-----M----------|-|------|M----------|------|------------------f
---?-------XXXXX-|XX------|------------------|---------------------|------XX--XXX------------------------------|---XXXXX-----|-------|-|----------------|-|------|-----------|------|o------------BBBBBf
m---------XXXXXX-|XXX-----|----E-------------|--------------E------|-----EXXXXXXX-------------------E----------|--XXXXXX-o---|-------|M|---------E---o--|-|------|-------E---|------|----E-------------X
XXXXXXXX-XXXXXXX-|XXXXXXXX|XXXXXXXXXXXXXXXX--|----XXXXXXXXXXXXXXXX-|XXXXXXXXXXXXXXXXXXXXXXXXXXXXXXX-XXXoXXXX---|XXXXXXXXXXXXX|XXXXXXX|X|XXXXXXXXXXXXXXXX|X|XXXXMX|XXXXXXXXXXX|XXo---|--XXXXX-----o-----X
