-------X------B----------------E------------------M---o-------------------M-----E-------M-o-------E-----------B-----------MX-----------------B------------------------------------E---------------------
-X--------------------BM-----o--X------M--------o-----------B------------B-----o-?----------------E--------------E----------E-B--B----------E---------M-?E-----------E----B-------o---------------------
---M--M--------------------------------------------M---------------------------?---B---X--------------B----M--X----------?-------?-------------o-M------o------------E----------MB----------------------
-X---B--------M----M------------------------------B----------------------------?--------?Mo---------------------o------------E------------o-----o--------?----X-M-------B---?--------MM--?--B---X-B-----
--------?-------B--------------------M--------?----------E---o?--B---------o-B------E-------------E-----EX---o--?-----------o---------?-------------------------------------M----------------o-------?--
------------------------------------X-------------E----X-EB-?E--------------E---X-----M---X----X------B---X----Mo---M-M------M--o---E?E-?----o----o---M-------------E------------E--------B-------o-----
-----B-----B------------?X------------------X------------------M-X--o--B-B?-------------X--------X--M-------------E-------oE------o--------------E-----------?---------------E-M---X-?------X-----------
-X------B----------M-----?-----?-------------------------M-------B-X-------B--------------B---B--?-EBo-------------------------E----------------------o----------------B------------------------M---B-v-
-M-----M?-------X-------------?--E?-X-?---E----------E--XX--X---X?X-------E----X---B--------X----------M---B-o---MM--o-E-?---X-XM------EE-----o---o--M---X------------X-B---E-----?-?---MM-B-XX-oX-M--f-
---oo-o--------M-----E---o---B?----E---?-?---X-EBM--M----?--oo--------XE------oEE--M----M-----------X--o------B-------?M--E----M-X-----------B--?-E----?-----B------o--M?B-E--M?--X-X--B-o--?-X--BMB--f-
-M------o--?o----B--o--XoX-?o-E-----??----o----------o-oXo-?-------?--E----X---M-X--?-ME-B----?----EB----E--o-----X-E-Mo-B--------o--o--X?-EM-----M-----M-oM-oB-----X?-?E-?-X-?-Xo-EM-?-M--X-------oo-f-
-E------?---o-------o--?--X--o---o--B--o-?XoM---B-E-o----------M-------MX?--?-B---?-?------E---XBE----o---M--M---?-----o--o---------X---?MMEoX-------?------B----E-M-E--E--Xo-------E--E-E---M-BEB--?-f-
---oo----o---?---M?---M-X-XE-Moo-----B-------?--BB--M--?MEB?--X--XoB-MB-----M----XX-----------B--?---X--M-M--B--?-Boo----E----M----M-----o------o--MB-?--oEB?-X--B-BEo---?---?M--EEo-----B------E-----f-
------o-o?--XTT---EX-T-oETTX------T--T--T-M--TXT?-E--?-B-------------T--M--?-T----?----T-EXM-----T-----TMBT-----?T-oE---E-BT-T----TT-------o--ET--?--T-?--T--E--BE-B-XT------T----BE-B-----E?--TB---T-f-
m?M----M-?---|||-M-?-|---||----ToX|--|-M|-X--|-|M--M-X-T--?X-o--Bo--E|T----X||---------|X-|E---E-|E---?|?-|---Bo-|--EM--o--|-|Eo--||---E--E-M--|-?--X|-EM?|-|E---ET---|-|---M|----EB----?-B----|----|Mf-
XXXXXXXXXXXXXXXXXXXXXXXXXXXXXXXXXXXXXXXXXXXXXXXXXXXXXXXXXXXXXXXXXXXXXXXXXXXXXXXXXXXXXXXXXXXXXXXXXXXXXXXXXXXXXXXXXXXXXXXXXXXXXXXXXXXXXXXXXXXXXXXXXXXXXXXXXXXXXXXXXXXXXXXXXXXXXXXXXXXXXXXXXXXXXXXXXXXXXXXX
