------X--o----------M--------------------------?-B-E-----------------B-------?--------X-T--------------MM--|-B------------|-----|------?---M---|-----T------------------------------|------------------|
-------------------X---------o--------------M-----------------------------|-----E--o----|-----T----------T-E------E--------------------B-----ooo---X-------T-X---BXB------B-----------------o-M--------M
---------E-----------M-----------------B------------|E----B--M----E--------?----X------------M-X-----------o--B----X-B----------------------------MM----------M------o------M-------------------X------?
-----------M----------o----------?--------?-E-E-X-----------M--T-----------------B---?M---------------------------------M------o---------------B-Eo---|------------------X-----------------------------E
-B-------X------|X----M-----------oX-B--Xo--Eo--?--E-M--|----?B-X--Mo----------------M-----------E---------B--Eo------------o----------------T---X-B-E-X-|-----------------------------------M|---?----T
---------T------TB---------------------?-|--E---------B------X-o----B-X--X----------------BBM-----M---------o-E-----------X--T-|-----?-------XE----|--------------------|-----M---|---------E------|---B
-------------------------TB------------------TT---M---?--?------T----T-X----T------|------M--------------|---X-??---------BX---X------B-----B--------?B----M---------------T-----TB----X-----M------T--o
---B----M-------B---B--X----------------------|----E----M-------?------oTE-----?-----------------|------------------T-----------------oB------------------?-T---o-B|---M--------------------M---------vB
-|BT-|EX-oX---------BM-|||---?---------------M----B-----|-------------o--|o?--|M-|X---B-X----------E-E-?--X---oE----E---B--X---B-B-|o-?----T-T-T--E----?E?---M--M-|-----B----|-------o-o------T-E-----f|
-?---TX--o-----T-----E?----TB-|-XE??--B-------MM-------oBX|-----|-|---B--?-----------|B|-B------TXTo--B--------E-----oB---???-oBTM--oo--B--o-------?TTo--M-T-E----B-o-|--B--|-T--M---?-EEBM----M---o--f?
---M-M--M---E-T-------T--Mo--E---M-E-----X--E-BBT-oE-----|oE?------E----M-?E--|-|--XT?-M-------T-------o--?E|--B----MoX-B--?-----M-o---M----?-o---M-?-EE-----M-E--T-X---?-X--|-B-|---o-M-E-T-----M----fM
-?-M-E-o-o-----T---Bo|--E----E--M-TXB-Mo---|--TMT-------EM?o------TXB---?--o-B-|---XT-|-EE--MM?TE-------TE-M--X-XEB---T-|X---oB----M|X----?-B---ToX-------T?EEE-?o--X?---M-|--EXB---B----T|---X-oB--?-fT
-E--|--E-----E----|-o?-?EoX-E---X-----o|-M-|B?----------?|-M--B-B----X-?----T---o---o--E-------oT----?-|-----|-------------B-?--o--M-B---E|E--?-|---o|-----X------X--------XTB|?-o--B--X---TB--B----o-f|
---B|-E---?-|------B----TE--B-------MT?-T---M-o----ME----ME-|------|o---------oX-T--E----E--T--------o-------M??----X|---------T-|-X---o-----E-B-EB--X-----X--o------B-MB--oM------EM-----?--?--------fo
mM-?--MT------------o--?-?----------M------E-X-o-?-o---T-----E-B-E---|-X?o-B---B---|M--o---B---M?--------TM----?--EM-----EXT--TM---XX-B------?-----------?---T--T-M--BM-----Eo----o-X-M---T----?--?X-B-?
XXXXXXXXXXXXXXXXXXXXXXXXXXXXXXXXXXXXXXXXXXXXXXXXXXXXXXXXXXXXXXXXXXXXXXXXXXXXXXXXXXXXXXXXXXXXXXXXXXXXXXXXXXXXXXXXXXXXXXXXXXXXXXXXXXXXXXXXXXXXXXXXXXXXXXXXXXXXXXXXXXXXXXXXXXXXXXXXXXXXXXXXXXXXXXXXXXXXXXXX
