------|-----------M------?---------T----------------|-----BX---------M-T?-----T--o--------|------------------|----------|?--o---------B---------B-|----------T-------B-?---------------|M-o--X--E------?
---E-T--|-|--X------|------------?o----------|------------T-------------B---MM-X---T--X---M--------T-M-------|-X-T-------B----------------M----B-------------?--B-?B---------o-----T--------------E-BE-E
-M------|----------T--XX-----o---TTT---------------B--------------------X---|-|------o--o--B-----B------------E----X--------------X---E-|---E--M----|---------M---?-----B-------------?---|---M---M----X
------o-X--?---------------------------M-----M---M-E--?---X------M-------------E-------E|---M--M-----------------------------E---------M--o---------------X--X----E--T-------X----------o-|------------|
-----|---?---------?-----------T-----?----E---------|T--TM--------B-M------?-o---------------?-----T----X----------------?----X---?-T------T---------------M-----?---B----------------------X--B----M--X
-------E-o-------------B-|--------E-ME-----T------XE----o---T---E----E-E-----?-o-----------------M---------------oTT-o-------o--?-------oM-----X---T--B---------------o-X---------------------X--------|
-o|---------X-E-----?---E---?-------------------------------------E-o-----------o---|---E?--BB-------T------------o-------|----------?-----------T-------------------o|---------------?-----------------
------X?-----------B----T----?------?------B-----M-------o-----------B---M----------|----------X---------T---M---|------------------?---X-B---|---------E|-----TE-T---------T--------X------?-o-------v?
---E-----EM---?M--T-------------?---?M----oT---?|-o?-X|--?T---oME-?-T-T--M-E--Xo?T-T----|-E-----T-----MT--T-------B-EX?---|?X--?---X-E-B-M--E--X--|B-----M-E--B-|-?-X---M-------X--E|----?-M--------E-fT
--?-o---M-----X-ME-X-M|---M--ToM----?--o-|M-BM-M----T---|-MXE-----------------XTETX---T-----oB---------TT--XM-T-E-X---------M-?--B--M-X|E--o--X-B?XoT--------X----------M|------X-oEBo-B--M-E-MB-?-X--fX
-E--TT---M--T----TX|-|--------X--M---------------T?X-|----|T-|--M-|-o----|-To-BBo-M---------X---|--T?-o||--------X-o----T----M--XX------oM-E-B-X----oM-X-|XM--T--EE|----XMo|--o------T--------|X---?T-f?
----|BE-M-|---|---TM--?-M|B??EEM---oM-BXM-|------|E-M?T---|--------T-EBM-|-X--------|--ToX--M--------?---E--M-X|--B-oX----------X-|-XT---o--B-?----T-|?-E-E--??-BTT---o------oTM?----XB-B?EXE---T-T-?-f|
--B--|--o-T-o-o?--------T?----X--B-----?ET-MMX------------?-E--oX--M-M--BE-o---B---E--X-?------------T-------|-----M----o-|--E---X----?-o--------Mo------oM--X-----EX--E|-B--X----?--?-ToEME----EX----fT
--X-T-T-?BE--T--BX---|T------T-E----T-M----EB-B----------?-----||-B-B--?MM|B--T--?|o-T---o-M-|o?-EE--ToX-o--To--E?----TB--o-X-M---|-T----X-----E-M--X-E---o------M--BET-oE-|---M-ET|B-o-o?---T-X------fX
m-----B--?-|o-?--T----X---T-T-----BoB?---|-E|------X--o-----X-oTM--M---o-M-|--E?-----BB---B-|TT-?---?-M-|-o--M-ETM-X|--E-o-MT-X-B--------M---E-|--------M-----|------XX-B---M---T------o-?-M-B---TMT-M|o
XXXXXXXXXXXXXXXXXXXXXXXXXXXXXXXXXXXXXXXXXXXXXXXXXXXXXXXXXXXXXXXXXXXXXXXXXXXXXXXXXXXXXXXXXXXXXXXXXXXXXXXXXXXXXXXXXXXXXXXXXXXXXXXXXXXXXXXXXXXXXXXXXXXXXXXXXXXXXXXXXXXXXXXXXXXXXXXXXXXXXXXXXXXXXXXXXXXXXXXX
