------------------------------------------------------------------------------------------------------------------o----------------------------?--------------------------------------------------------
---------------------------------------------------------------------------------------------------------------------------------------------------------------------------------------XX---------------
----------------------------------------------------------------------------------------------o---------------------------BBBBBBB-----------------------------------------------------------------------
--------------------------------------------------------------------------------------------------------------------------------------------------------------------------------------------------------
--------------------------------------------------------------------------------------------------X-----------------------------------------------------------------------------------------------------
-----------------------B--------------------------------------------------------------------------------------------------------------------------------------------------------------------------------
--------------------------------------------------------------------------------------------------------------------------------------------------------------------------------------------------------
--------------------------------------------------------------------------------------------------------------------------------------------------------------------?????------------------------------v
----------------------------------------------------------------------------------------------T----------------------------------------------------------------------------------T---------------------f
-----------X---T--------------X---------------------------------------------------------------|------------------------------------------------------------------------T---------|--------------------Xf
----------XX---|-------------XX---------------------------------------------------------------|-------------------------------------o----------------------------------|---------|-------------------XXf
---------XXX---|------------XXX---------------------------------------------------------------|------------------------------------------------------------------------|---------|------------------XXXf
--------XXXX---|-----------XXXX---------------------------------------------T-----------------|-------------------------------------T----------------------------------|-----X--T|-----------------XXXXf
-------XXXXX---|----------XXXXX---------------------------------------------|-----------------|-------------------------------------|----------------------------------|--------||----------------XXXXXf
m-----XXXXXX--X|XX-------XXXXXX-------X-------------------E-----------------|-----------------|----------------------------------E--|-----E----------E-----------------|--------||---------------XXXXXXX
XXXXXXXXXXXXXXX|XXXXXXXXXXXXXXXXXXXXXXXXXXXXXXXXXXXXXXXXXXXXXXXXXXXXXXXXXXXX|XXXXXXXXXXXXXXXXX|XXXXXXXXXXXXXXXXXXXXXXXXXXXXXXXXXXXXX|XXXX-------XXXXXXXXXXXXX-XXXXXXXXX|XXXXXXX-||XXXXXXXXXXXXXXXXXXXXXX
