------------o----X------------------------------------------------------oM--B--X---Bo-?---|-X--------M---o--------------T-|------|----M----B-?-------------?E----T----------------M-------M------?-----o
--X---------?---E----------M------?--o---------E---T----?---T--------T---|--o-----?--E-----------o---------?o------------------B---|----------T----o---M---o------------------------M-------------|B---o
---------------B----E---E?---o|------X-------E-----------T|---------EME------------------------B--X----------X--------X-------|---------E-----E--------------T-------------|--M----------?-------------E
------------------B--T----------T---------|-----B-M------------B---------|--M------------------?----T-?--------------T|-E-X--B---------------X-----------o-E----------------M-----------T---------------
---------------M---------T-----M--------------T--E-------E--M-------------------------------?-------X---------X--------T?--E--?------X---------------M------------?------------T-T?M-B-----------------|
-T-------------------?---------------------BM---B-------X---X-------|-------------------B-------E--o--o---|----------------MM-----------------Bo-----------------------------------------?----T-----B--E
-----------B------------------||------------|-----------M----------------?-----X-o------XM---o---|--?---E---|B-------------------B---E--M-o----------|------------------E-----T--M-M-----------?---o---|
-------------------------------------T--M-------------?-T-------------|------?------------------------------X-M---T---------|--o---------o?----------------M--------|------|-----|----|----------EB-M-vE
--------MMoX--?T----X-oo---Eo-------T-M----X--B----M-o-B--ME---|---X------B-------M--E-------|-E-|B-E|---E-ETT-E---?--T--EB------X--T----M|----?|?---T--B-?o--o-M--XM------------E?--|o-----|-TT-EoM--fX
---B-----T-----B----o-???B----T|---M-------E-E---??-o-------------ooEM-T?T-o-?-----M---X-X--XBoMoTX-------BM?--oX---------B--oB-|--X|--B-----M----E-?-oE?ooEEB-M-------TM-------o--XEo---?-M-EE-T-EE--fX
-M-?-ToX---X-|-------T--XE?-|-E------B--B-oE|--X--|-----B--M-TEMT-EE--------?----T|T---?T--B--E--X-T------o--?----T-E-----MT-o--BB-BEBX----?-E-M--oo----o----------B--?----o-B-----oT-B----?--B----MX-fM
--XE-?E-o--M-------E-o----B-?---BE-?-|ToE-T-E--|E--XE---o-o--|--|--Eo---E-X?---X-----------X?-M--T---Xo-EE-B----|-E--|X--MTE-X--B-ToM--E-|--M-T---|?---M--?oBB--B-------?----||-o-M-TM-?-|--B|-|E-----fM
-?-M--TTT---M--TB|-|T-----MB----T------EBo--||--TE---o-?-?--M--------EM---------B-EX-TB?|-----X----TT--?||EMB-|o----EB---|o-|-X?---T----X-T-----|oB---?ET-----?-B---X----||M----?-M-|--E-o--BT----?---f-
--?---E|----E---T-B--TT-----B-MTB-------|---?o--E--E--oM--EX--oE--|--T-BM--oT--|M--?---B--MB-MB------E--------B-X-|---------------XX-B-?--------B---B-B--?-MXX---?B-B-o|o-T--Bo------M---?---?-X--oB?TfT
m--M-E|o--?X--TM----E|X-----M-TB---E-E|-B|-T-oB?--M--?Xo------B-----XX-----XTo-M---o-|-T------|E----?-T--E---X-----BX--?--o-M-X-|M--TTX-T-B-M-B--E-|--E|X-M--X-B-------|--BT-|----M-T--X-----B--o--?X--M
XXXXXXXXXXXXXXXXXXXXXXXXXXXXXXXXXXXXXXXXXXXXXXXXXXXXXXXXXXXXXXXXXXXXXXXXXXXXXXXXXXXXXXXXXXXXXXXXXXXXXXXXXXXXXXXXXXXXXXXXXXXXXXXXXXXXXXXXXXXXXXXXXXXXXXXXXXXXXXXXXXXXXXXXXXXXXXXXXXXXXXXXXXXXXXXXXXXXXXXX
