-------------?-----------------------B---------------------------------------------------------o--------------------------------------------------------------------------------------------------------
-----------B----B------B-----o-------------------------------------------------------------------------B------------------------------------------B-----------------------------------------------------
----------------------------------------------------------------------------------------------M-----------------------------------------------------------------------------BBBBB--------M--------------
------------------T---------------------B------------------------?-------------------------T-----------------------------------T------------------------------------------------------------------------
------------------|------B---------o---------------------X---------------------------------|---------------?--------------XX---|----------------------------M-----T---------X---------------------------
-------X----------|-------------------------------------XX-----------------------------?---|-----------------------------------|----------------------M-----------|----X---XX---------------------------
-------XX---------|--------------T----------------?----XXX-------------B-------------------|-----------X-----------------------|----M-----------------------------|----XX-XXX---------------------------
-------XXX--------|--------------|--------------------XXTX---------------------------------|XXXXXXX-----------------?----------|-----------------?----------------|----XXXXTX--------------------------v
-------XXXX-X-----|-----T--------|-------------------XXX|X---------------------------------|-----------------------------------|-----------------BBB----------X---|----XXXX|X-------BBBBBBB------------f
-X-----XXXXX------|-----|-------o|------------------XXXX|X------XXXX---B--------T----------|---------------------BBBB----------|-----------------------------XX---|----XXXX|X--------------------------f
-------XXXXXX-----|-----|--------|-----------------XXXXX|X--------?------T------|---------X|-----------------------------------|----------------------------XXX---|---XXXXX|X--------------------------f
-------XXXXXXX----|-----|--------|--------------?-XXXXXX|X---------------|------|--------XX|-----------------------------------|---------------------------XXXX---|--XXXXXX|XX-------------------------f
-------XXXXXXXX--T|-----|--------|----------X----XXXXXXX|X-M-------------|X-----|-------XXX|------------------------X--------?-|-------B---------o--------XXXXX---|-XXXXXXX|XXX------------------------f
-------XXXXXXXXX-||-----|-------T|--------------XXXXXXXX|X---------------|XX----|------XXXX|------------------------XX---------|-------------------------XXXXXX---|XXXXXXXX|XXXX------------------M----f
m-EE---XXXXXXXXXX||-----|---EE--||------E------XXXXXXXXX|X-------E---E---|XXX---|----EXXXXX|------------------------XXX--------|---????---E----E--------XXXXXXX---|XXXXXXXX|XXXXX-E------E-------------X
XXXXXXXXXXXXXXXXX||XXXXX|XXX----||------------XXXXXXXXXX|XXXBXXXXXXXXXXXX|XXXXXX|X???XXXXXX|---XXXXXB-----XXXXXXXXXXXXXXXXXXXXX|XXX-XXXXXXXXXXXXXXXXX?XXXXXXXXX--X|XXXXXXXX|XXXXXXXXXXXXXXXXXXXXXXXXXXXX
