-------X-|BX--X---------B--------?------------------------------B--------E-----------E-M------E--T--M--------------------E----------------------M--XB-------------M-----------M------------------?-----o
-----------|---------o-----B----------------------------o---?-o---o?-----BT----B------X---------o-------X-?|----------------------------|-----------M-------E-------------------M?-T-----E---?---------B
--B--------------------------o---XM--B-----BE------T------T-X-------B---------------|-----------------T-------E----M-o--X--------X---?o--X--------M-----E--------------?M---------X---?---?----------B-o
---M---E--?---------X---B--?oT-------?B--B-----------|---o--X-|----X--E-----------E--------M----E-----X----------B-M----------XM---------M---E-------------T--E------------|---E-M--------?------------X
---B-----------|-----------B--T-?--M--------------------B--M----------------E----------?--|--------B------------------------M--M----EX----------M--|--------------------T---------------------------o---
----------X--------?-------------o--------------------------|---------------B--------------?------?----------B-----T-----------o---------?----------oE-------------------------------o----B-------|-M---
---B---------B----T----------T--?--------E--------M----X---o-------------M----------------X|----------------B-------------------------------T-----B-o---------------------------------M---E-?----o-----T
---------o-------|-------X-?o--------M-----M--------------E--|-----E-------X--------o---------------X-------------B-|--------------E-----------------o----------?--E----------X----B-----X-??---------v?
-o?MM----M?-?BB-|--|-----?----B---------M-MB-|---E?--EE-?---|--TT||o-|--|X-X-TB------M--T---XM|-M--B-E---|---?-B?Bo-?-M---M--|M?-M---B---T--||-o-?T--|-E--B-|--o--o|--o--|-B--BT--o-------??----Mo-E-XfT
-?-X-MT----MB-B--|M-?--BM---T-E--B-E-M--E-------?-----TX-----o?E---B-|o-------M--|-----------E-----X-E|------|--------TT?-T-E-X--B-o--------o|B-|---?--o|---T----------B---oB---E----XT-----?T-----M--fB
------|T---X-?EE---To----T--o-T--?--X|--|--X--B--------?o--M?--METET---XT--E------T|--TooEB-----E----T-o-B-T-o--------TE?-o---EE--MX-----T--B??TX-|-||BE---B-|--E---o--o-----------|-E-o----o--T-o--?-fX
-oE--|B-B|-----o-?o-B-?----X-M--E--E------X------|-|---?T?|--|EX|-?--XE-E---B---TB----?-T-T-M-E--|----T-E----ETM-M---X|---XX------B-------?BBT?--?------X-----X-|--|----B----B--T-|E--?E-T-T-?--B--?--fM
---B--------oE------?----XXB-----?-??-E---M-------------------BM----?--X-M|----X---X-BX-T-----Mo-|?|----B----o-BE|M--X-|X|--M--T-E---M--|----|-|---XEE-T-----BMB-?-----M??|X--?----?-o--M|--MT--ToT---f|
-E?-X--?--EEME----B-X------B?---||----oB-----Xo-B----T-T--?BM|--X--MB--M--T---BE-X?--EMo-----------o---X-o?o-------B--B----E---X-?-o-|--EX---E-------?X-X-E--|o|B----------XE---X-T--M?-E-E----|----B-fX
m---|-T-|--|--M----|M--T--------?-------B-|--E-E--X----B--B-M--XTT----B|--?-?-X---E|E--M----B-----------?|-TX--M-M-o---TM---T-TB-----|----------o-?-----T-T-----oM---??-----X--------B--------o-----T--B
XXXXXXXXXXXXXXXXXXXXXXXXXXXXXXXXXXXXXXXXXXXXXXXXXXXXXXXXXXXXXXXXXXXXXXXXXXXXXXXXXXXXXXXXXXXXXXXXXXXXXXXXXXXXXXXXXXXXXXXXXXXXXXXXXXXXXXXXXXXXXXXXXXXXXXXXXXXXXXXXXXXXXXXXXXXXXXXXXXXXXXXXXXXXXXXXXXXXXXXX
