-----o-X---------|----B-----?-B-M-?-----M|----------------------------------------?-------E---X---------o---------B-------E---B--?------------------T------E----|o------|------------------X-----------?
------T-------o---------------o-M----E-------BBE------o----------M---|------E--X-o-------------B----o-------------------------X-X---T--------M--------------------------B--B-M------E---?--------------B
---------?-----|--E--------o---o-M------?-------------------Bo-B-------------T--------------Xo--?-?--T--------------o-------------B------------|----------------?--?---------?oBBX------|-E------------o
-o------E-------T-------------TX-----------|--B--M------|-----T--M------------o----------------E----M---B--?-----------------|--------------------?--|-----------X--B--------E-o--E-?------------------M
-|----o-M-------------------------------T------T------ET--T---|------------------------B--------E-------M-To-T-?-----------------X------B---------X--X-----o----------------------?--------------------M
-?T--B--X-----o-------?-----------X-B--------------B----B---MX---|B-------------B-------E------------|--------------------T--------E-B-------X---B----B-----B----E-------------|------?-----MB---------X
-E---------------------|--------|------E---|-----X---?-----M----T--B--M-----------E-------M----------X?--E-----------------------?M----X------------M?-------------------TT--------------?-------------E
--|-M-----T-----o-?E-------E-?----|----------------X-T-B--------T----------T------MX------------------o--T------T------B------------------------X-B------------------------|?-E---------------------M-v-
-o--?T-o|----|----E-o-M----X-----B-T-----------------T-?-M-|-|-oXB-----|XE-M----EM---|X-TB-M----------o-Too-------X-T---oooo--T-----E--?-X------BTTXM-B-----X|-?o---------?--E-------------M--X-M-EX-ofT
---X---M-T--M---T----T--TBM-----|BE-X-M-?oM-------X--?-M-oEB-BEE-Bo----M------B-|----X--o-T-o-XX-------XXM-------o--?MXM-T--o--B--|E--o-|-ME-------|BT--?--X-o--oE-E-E-?EX--o-oT---X--------B-----o-|-f?
--MM---|B-------------X----|o-oMBT|-|------M-T----?-|--T--M--B--B----oBX?|----B-E?-TBE--M-B--B-MM---o---|M-----?-T--MT-|----|E-----T----B|-|------?--E-----M----E--M-TM----------T---------TE-----E?--fM
--o-?M----M-|oM--?X---|----|---o-ME---------o-XoXE-----o--X-|-----|o-----EM---?o??M-E---oo|---|--?----|-----BT-----M--X-E-M-------------MM-|-MB-|---|-Bo-M--?-|---?-------?---B?-EEoE-E--BX-B-------E-fo
-X------?|------MM-|?-B--o?M--?--o--|-----M----?--oX-o-E--|X-T---|----B----|-B-X-B|---MBoE---ET?--?M-|--E--T-BT?--|E-----E--?X---o---|-?-----EB---------o?-E----E?--?-XE---EB--X---T-----T--o?TBT-|-|EfB
-|----TBB----T----?---M-----|?T--|T--BM--|o--T-B-o----X?|------M---?-E----?XM-T|-|M-----M----MMo--MBM-B-?----|-?Eo-To|-B----?-o-E-----B-oB----M--|-?B-|-|-T||--T-----E-E--------E?--|-----BET-?-o---TBfE
mM--||---o-|XE?--|---T-E??--T--MM--MXEM-E------o|-----TM---X-X-?--|-X-E-?-----------|----oo-X-BMM-M-XM----EB----M--?----X---B----B-----E-----|--o----X---------X---B---To---------------o--?--X-T--T---?
XXXXXXXXXXXXXXXXXXXXXXXXXXXXXXXXXXXXXXXXXXXXXXXXXXXXXXXXXXXXXXXXXXXXXXXXXXXXXXXXXXXXXXXXXXXXXXXXXXXXXXXXXXXXXXXXXXXXXXXXXXXXXXXXXXXXXXXXXXXXXXXXXXXXXXXXXXXXXXXXXXXXXXXXXXXXXXXXXXXXXXXXXXXXXXXXXXXXXXXX
