--------------------------------------------------------------------------------------------------------------------------------------------------------------------------------------------------------
--------------------------------------------------------------------------------------------------------------------------------------------------------------------------------------------------------
-------------------------------------------?--------------------------------XXXXXXX---------------------------------------------------------------------------------------------------------------------
-------------------------------------------------------------------------------------------------------------o------------------------------------------------------------------------------------------
---------------------------------------------------------------------------------------------XXXXX------------------------------------------------------------------------------------------------------
---------------------------------------------------------------------------------------------o-----------------T----------------------------------------------------------------------------------------
---------------------X-----------------------------------------------------------------------------------------|---------------------------------------------------BBBB--------X------------------------
-----------------???XX-----------------------------------------------------------------------------------------|---------------------------------------------------------------------------------------v
-o-----------------XXX-----------------------------------------------------------------------------------------|---------------------------------------------------------------------------------------f
------------------XXXX---o-------------------------------------------------------------------------------------|---------------------------------------------------------------------------------------f
-----------------XXXXX------------------------------------------------------------------------------------X----|---------------------------------------------------------------------------------------f
----------------XXXXXX------------------------------------------------------------------------------------XX---|---------------------------------------------------------------------------------------f
---------------XXXXXXX------------------------------------------------------------------------------------XXX--|---------------------------------------------------------------------------------------f
--------------XXXXXXXX--------o---------------------------------------------------------------------------XXXX-|---------------------------------------X-----------------------------------------------f
m------------XXXXXXXXX-----------------------E------------------------------------------------------------XXXXX|-------E-------------------------------XX----------------------------------------------X
XXXXXXXXXXXXXXXXXXXXXXXXXXXXXXXXXXXXXXXXXXXXXXXXXXXXX---XXXXXXXXXXXXXXXXXXXXXXXXXXXXXXXXXXXXXXXXXXXXXXXXXXXXXXX|XXXXXXXXXXXXXXXXXXXXXXXXXXXXXXXXXXXXXXXXXXXXX--XXXXXXXXXXXXXXXXXXXXXXXXXX-------XXXXXXXX
