-o------|--------o----------o--------B-----E--|----T-?--------?---M--T---------E-----------B--M-E------MX---T----o-------|------B-------------o-----------?----------E--------------?-----|----?--M----E
----------Bo--------o---E-----T-----o-------E--o--|--------o---M----------------B--X-----E------------------------------------B---o---|-T-------------M----|---------|-------------------X--------T----T
--E------------------------------TET?T-T--M------------o-------------------B---E-------X-----------------?-----T---M---M-----M------------M------M---M----MM------------------------------M------------M
----------E---------M-------|----B-?---T-------------M----------E--X-X------------M--------|---M--Eo----------?--?---------B------------?--oT-------B--------B----o--------T----T-----------M--B-X-----E
--------------?-------T-----T--E-------B-----?T----------o---B------T-B--T------?------------B--M-------------------T---|----------o---X--------M-X-M-------?-o---|---o------oB------------------------o
-------T-E---B-T-------X---------M-E-------T--------?------------M-----------------------B-----------M-B--?X----------M-----T----EM---------E---------------------------------------------B--E---------M
-----------T-------------------|----|--X--M-------X--------T------------B-o--T|--------------XT------X------X-|ET----------------T-------------B---T--M-XTE-?------E--B-----M------B-------------------T
-------E-?--------E----------------M--T|--?M---------T?------?------o-E-------------------------------------M---------B----------------BM---?-------------X-----?-----B----E-----o-----?-----o--------vo
--|-oX-B-?-oB--M---B----|-T----o--X----TE---M-----------|BM-MT-?|M-------|-E------E-----oMMo-B--|-------M----BE----M-M--?T---o?---X----E-o----?--o---?E-X-MTEE?|------XBM-?--M-|||--T|B-E?o|--o--TX--MfB
-o-----B------?---|-?----TT-T-|EM------|--o-M-M-T--?-T--o--M----M----?-?M-B--o-B??------M---M-------o------X?----o------|-|-------o-?-o----|EET|--?--?X---M-----M---o-|---TB---E--B--?-|-----B-----E--f|
-E-------B----M-E------X-------?B-o---|--XM-o-T--E-B--?-?-E---Mo----EB----oT-------|-T-----??---oX---?-------E?---BXB------o-----------?oo------?-----B-------T-TX--------Bo---M?X--|--M|-?X?--B?----Ef-
---------X----MTE-------B----------B--?---XXXT------XXTo-T-------M-------T---?---T----E--------o--------E--M-----X-E-----o-o-T----T-T--Eo--|BM--?-XE--?|T--M-B--|-T--M-B-----B-----M-------E---?-?M---fE
--E-|--T--ET------X--------T|TM--B---|-----|-?---??-|?XX---T---BE-X?|-E---M?X---M---------------B-------E-?-M--M-E---o-TE|-o---M|--?--E----?----X-?-B|??o---oE-?-B---B--M-M-B--M-BX--T-?X--?---T-?-T--fo
-X-E--XE----X-T-M---?--?-T-----M------?|-E-B?-M-E-|T--|-E-X--MB?---XE-----T-------Mo--?B|--o--X-----M-----X-|-|----|-B-E-X|------X-----MM---T-T--E-Mo---E--X--E----T-----TB----TMM----T-|?--?E--|--E--fT
m|-----|--?-M-----|-EX------X-B-o--------E-MT------?-E--o?B------B-|-oB?E-o--TB--Mo-E-M--o------B------E-----|||-----o------|-|-B-|---B---E--XTT--B|o--X-|M--?---T--|--X-|o--B--M--E-?-B------o--M-BX|-E
XXXXXXXXXXXXXXXXXXXXXXXXXXXXXXXXXXXXXXXXXXXXXXXXXXXXXXXXXXXXXXXXXXXXXXXXXXXXXXXXXXXXXXXXXXXXXXXXXXXXXXXXXXXXXXXXXXXXXXXXXXXXXXXXXXXXXXXXXXXXXXXXXXXXXXXXXXXXXXXXXXXXXXXXXXXXXXXXXXXXXXXXXXXXXXXXXXXXXXXX
