-T-----------------------------E--o----E-----------X---|-----------------------o---------X----X----o---|-----------E----------------E-------TX-------X-M|----?--M-M?---------------------?o--------|-X-B
-----E-o--------------o---------------T-------?---------o-oM------?----------?------------E---------------X|-----M-M----M--------------------|-----------------E-----X--T-?---E------------------------B
----------------X------?----------------------------T-E-T---------------X----------------M---X----?o-------|---------------o------------------M------X-|--X-------------M------------------------------T
--?-----|-------X-------o----B-----o-?-B----MXT-----o----?-----T--?-----E-----------B--------B----B----|----M--X----oT-|----E-----?-------|X------T-----|M-------X-----?-----------------?--------------
----E------T-M--------M-|---?--------B-----X-X--XM----?--|---------T---------M-----M---M----------|------------o--M------------|--B---M-----E----E-------------------X-------|E------T---M-B-----?-----o
------------B---------B-----|M-------------M-------E-------B--B---X-----------T--------|-----MT---M---M---------T------------------------T--B---------------B-----B-------B--B---------?---E----|--B---B
----------------B----E-o---------------------------|---?------|----T----E----------M-------?----------------M-------?----------T-------E--------|T---B------------------------XMM----E-----?----X------o
--------|--M-----|------M----E--B-X----M----------M---|------------------B--------oMM----B---|X--?-------X-----------M---------------B-E-B----T--------------------|XM----|------------------------T--vB
-X?--|--T----?B--E--TTB||----Eo-?-----|o-----TTE----|-----BM-M---T--BM-T----X-----------EE--?B--o-----|-XM--M|--XT----?----o?------XX-----M----?EX--------E--M----------|--T----|--M-|--T--B-?-M---X--fo
---?EE---------o--XB-M-?--oo-BM--?------TT----|M-E-X----B--||---o-|------M-MB|------?-BE-----------B-ooM--o---|XMM----o---X-E---BB-|------------|----M?M--T-?------TT--E---Mo---?Boo--X------T??-|----f|
-----|T---B--?--EE--B------E-----M--E---------|ME-M-|------X---E-?Eo-|-----E-T--T-BT--X---X?-XXEM--|----X-oo---oM-----E-?--?|MM-----MEM----E----E---X-BT---|---EE------o-------?----|-----o-B-?T--E---fM
--B--o--|--T-T--T---XME-----B-T----------E-|---ME-|-E-----?-|MX---?-E-o-|---EM-B--X-B----?E----o|-T-|E-----------?E-B---o?--M--|-To?-T---M-EXToB------|--------M-X-------o-------T-M-E?-o---|M-o---B--f?
--T--X---?-?|-XMB|----B-E-------|MX-E---?--|-B----oE--X---MB?---|--Bo--X|-M?-------MBB-E----B---|----oT---M-?M?oo-------B-o--M|-M-T------B--oo-?---E---|X?--o--X-??-T----M---------B--EE--E--E|----?--fT
----M-M?---?--X--B----EB-MBX--?E---M-----B--M------B-M-E---BM-o?--B-o-----?---M--M-|-TE---X?MEE----oX-----BM?-MT-T-?T---------T----oM-B--?MM-|o-ETo-EM-|T|-?E--T----BT---o---o?-----BB--Bo-oX|-o-oX-T-fB
mMEMEE?--Eo--|MT----XX-E-E----Xo--M--M-T-----?-X|T----EM----TM--??--X|---M-?B-B--T-B|-o------TT-E--EX---X?------?---oo-------o--?-oM--o-XXT-X--X-----M---?----E--BoBT----M----------B---T---X----EM----T
XXXXXXXXXXXXXXXXXXXXXXXXXXXXXXXXXXXXXXXXXXXXXXXXXXXXXXXXXXXXXXXXXXXXXXXXXXXXXXXXXXXXXXXXXXXXXXXXXXXXXXXXXXXXXXXXXXXXXXXXXXXXXXXXXXXXXXXXXXXXXXXXXXXXXXXXXXXXXXXXXXXXXXXXXXXXXXXXXXXXXXXXXXXXXXXXXXXXXXXX
