----E--------M-B-------X--B-----M-----?-----|---|---------------?---T-------------|?-?----------|--------B-----?---T--------TM---M-----------|---ET--------?------------X---------------------------M--T
--------|--------B------------X----|T-------E------E-----o-o--M------E----T-----X--E?-----------------B---------B----------BEX-------------------------M-B--X--o-----------E----E-----TT-------------B-M
-M-B--X-----?---E-E-----T---B---X--------X-----o-------X-------?-?---X--------M---------------E--------?E-------B--------------X-----EM-|----------------X--X--------------T------M-------E-?---B------E
----------?-------------o-T--X------oB----E-------------T----------X------oEBMo-------X------|E|--X--------EE------|-B-B-MM--------?------B-B-----|----M--M-------B-------T---X-----Xo------?--E---M---T
----oE-------|------|---------B--|------E--X----------X--------------o----|-|---EB-M------------|---------------E---------E--E------T-o------|-------------X--T----------EE------------------o---------E
-------------|--?-?--M--------------o----------?--E-----------E----------------------T-MX-------MB-----?o--B--------------------X---X------------------o-------?---------|---------------M----B-----EM-M
-B-T-----------X-----|----M-E----X--o--------E-----M----o---?X--------M|M---E-------------------------?-----|-------------------|------??---M---------E------B--X-----o----T-------------------X--o----?
-------|--------E|-------?---B---M--------E------------T------------|----------------------------X------M--------------|-------|---------?-------?B---------|--------X--------------------------------vT
---E-ME---|--X-T--EE----MX---Eo-----B----E---X--|-||---TMM---B-M--|E---MXT---B?E-TX---E--------ToX--B---T-TB-X---E-XT---EX---B------?T-|--EM-E---T-----M?||?-oB-oX|-E--------o---BB?-EX--MMBM|--B--X-|fo
--o--M|-o-?X--------T-T--B---XTM-EX-M---E-XB?M--BMX-E--?-----------M--XBo-B----T-M----?--o---B-??----o----X---||oM------oEo---?----------?-----oBB-?-?-o-?---|--BEX---|--|----E---?--|-|--EE----|-?B--f?
--o-XB--o--------X-oT--E---M-B-M---|-E--E-XB|X---BE?-X---------Xo-----EM---|-----?M--M--BT-MM-X|------M------Mo-X-X-|?-TE---X--BB---o-o---TM|--ETT--?---|?oT--M-----B--T----E----?E-|-M-----E-----MB--fM
-|----M--TT---o--|--|-----|B-----E-EE-?--TTB|-|-E-TM--oE-o----|?|----X?EoE---MX--M-XE--B|XB|-----?-T---B---o||-----X-o---?--B--?-----T-EX--o---M--|o-X--T--------XXT---?-----T----?BM--|-?TXE-X-o-|-X-fX
-|----?T-B-E-?-EB-M-To---?--?X-------------XXo----?T--------T-M------X-MM--ET---E-TE--?E--?MB----B-o--XMo-|---?--?------TEM--|?----X------?M----o--M--oE-T---oB--B?---|----E----BX-----------|--E-M-X-fX
-------M--T--B---BE--T-----------XME-----E---M--M---B-X--E--T-o-----o-|MM---E--o-------To---------------|------------Eo-B---oB---M--T--------X--B---?--?--o--TX-?o----T-|----o----B-Bo-B-T---o--M---|Xf?
m--X-----B-----M?------o--|TB----T--------?--|--E---?-MoX------?-MMo-?-X----BoTB---Bo------XMM--------T-o---|---EE---oB----o?|-M-----|Bo---X-----X-o---|---o--?|TE---BT-ME-M----M-X--E-B-XM|o-----M---BB
XXXXXXXXXXXXXXXXXXXXXXXXXXXXXXXXXXXXXXXXXXXXXXXXXXXXXXXXXXXXXXXXXXXXXXXXXXXXXXXXXXXXXXXXXXXXXXXXXXXXXXXXXXXXXXXXXXXXXXXXXXXXXXXXXXXXXXXXXXXXXXXXXXXXXXXXXXXXXXXXXXXXXXXXXXXXXXXXXXXXXXXXXXXXXXXXXXXXXXXX
