--T-T---------------E---o--T------------T-------M----T--X----------E------E--T------------B-------B--------------M--------------------M---------------B--T-------?------------|-----------X-T-----?----|
----T---------B----------?---------T-----------X--?----------|----B-----?-------?--------B---------------------------------B-----------?-----o----------------------------------B-----------------------
--------------------M-----B------------T--------------B-MB?--E--|------o---------X---------X-------------|-----o---o-E-----M----?--X----------o--M-------B------------?-o--|----------------------------
-M----------|E-----T-|----------?-?|-X-----|-------------------o-X---X---------o---------B------------------X-----?--E------------------------?------|--------------------------o------------?---o-----T
-B------------T----------------|-----E----------------?------------T-E---------|X--T----------------M-M--B---------------BB---TXE-|-----B------X-----EX----B--------------B---E-------B-T-----------E--E
-------------M----------X?--------?-------------------E----------X----------|----------X------X--------------------------------------X-------B-?XX------------BM-|------o---E--------BT---o--o-------|-|
------------------------|----------?-o--E---------------------|--------|?---------X------?-----X---MEM----E-E----B----------------o------M--|----------E-----MM------------B---T--------T-T---------o---
-?--------M---------B--------M-----E--------o-TX-------------------?-----M-|?----|----------------------------------??----E--------M-XB-----------o----E------------|------------TT--------------|----vo
----Xo-----oM--------B--M--BTT-|--B--?-|-X--B----------Boo----TE---M----E----E|-X------|--|----T--o-?----T-|-T---Eo-|------M------B-|--X-------oX-E--|-X---E----?----oM-T---|ToBB--B--?-----TB----T-B|fo
--E------M---B--B------T--B----X-T-o---B----TM-|?---?----o---oB|E-?E---E---BB-----E---X--o-----o--BME-E?-|---T-B-----------ME-----T-ME--|----TX|--??-T-|E---o----B-T---|---B-B----o-MT-T-E---ET-|-M---fX
---?--o------X?---?--|----o---o-M---------------TX-|-----E-----?-|---?------o------------?E-MXT?-TM---T--T-|M-MM---XET---------Mo--MB----?BMo--T---BTB-|--?--?---oo?oo?T----M-T----E|---XB-Moo--M--E-ofE
-X-oT----X-----------|B-|--TM-------T-M-E--T----Xo-B--oE--XXoX-|X----T--?|----?--o-T-?---Mo-B-E-E---B---?---o----X----E------------X|M--Eo-|---M|o------?-M--E|o--XX-TTB-M-B--Eo----X--|-o|--?-|EBX---fB
---E----||-T--E--M-o--X-?----T-o----?o-oB----M-T--?--E--|MXT--o--X----X|-----T--E--|MT---|------M--BE--M---o------|--|--X?-----o-T----X----|E------|-----M-T-?M-------X--?T?-----o----T-----o--?BX----f|
-T--?|MB----Mo--|--?-T-----MTo--o-?-M------------B-o--X---XX--o---B-----------E-To------B-X-E----------B-E--E------o-E-M-T-M--ME-o---E---EB---E--o-?----X--?---XB-----XB-M--o--|------?-M--M---------Xf?
mM|B--X------?-|--B?--|-?---T-|-XM------?-T-|-B--?---X|----TB-TB-M-----?-E---o--?----M----X?-X--|-?---M-XT-o-TX--o--BX-XT--------E-B--M-MM------T---|M-ET-|XoEoME-|--------X--|-M----M----o----T----MEXB
XXXXXXXXXXXXXXXXXXXXXXXXXXXXXXXXXXXXXXXXXXXXXXXXXXXXXXXXXXXXXXXXXXXXXXXXXXXXXXXXXXXXXXXXXXXXXXXXXXXXXXXXXXXXXXXXXXXXXXXXXXXXXXXXXXXXXXXXXXXXXXXXXXXXXXXXXXXXXXXXXXXXXXXXXXXXXXXXXXXXXXXXXXXXXXXXXXXXXXXX
