---------------|------?-------------T?--M---?-|---ME----E------------------T------------------------------------X------------------?-XX----M--------------------------------------?E?--o---------------?
----?-----------------------B------T-----M---------o-E---X----E----|B-|------------T--M|---B--------X---------------------?----X-------------------o------------|o-----------?---------------E-o-E-T-o-o
---------B------------------E--B----------?B-------X---------------X--X-----------------|------------------?----?B--o---o-E----------|-----X----o------M--o--------X-------?---X-|----------B----------o
---|---------------------X------E------BEE-------o-------------?--------------T---------------?----------E-------M---------------?---------------------B-------------------------------E---------B-----M
--E---T----------T-M-----------------BM---M-------------||B-------------M-------M--M--------X----?------------o-------E-E---B-M---E-----M--------|--------------------T---X---------o---E--To-------X---
------ME-----o----M--E?M--------XX--------o--T------o----------------T-----EE-----|----?---------E-------------?--|-o-B|B-o----M-?-------o------------------B-----------M-E-------o---------|----------o
------------X-------------M-------------M-------|?M-M---------------------------B---?--------------------------?----------------X----M---------------E-------o--------|??---o--------------E------------
----M-----T-M----M--------------?-o---------------o--E--T--------E------T-E--------|----M--------M---M-B---M-----B-----------------------X--|T---?------B------XX---?------------M------X-TX------|---v?
---o------?--BE-?-X------|BM--oBE---?X-------?-o-M-----X-B-----BB--------o--?---|-?-M----?|--|M--Bo?-B--|M------------o-----?---TX-|---X-|---E-M-TB-TE-------T|E?-X----M-B--BX-B------------|-X--T-B-MfB
-------Bo-|BXME?-oX--XTB-------BX----|-----------MMBo-T----o-----B-|--|----T--?-?---T-B---|?--|-?-oTBoM---T-T----Mo-T---?--B---------?----M---M---M?M--X---------------ET-M?E-X--XoB--------XT|E---oBTf|
-------ET?|E?TX?------?-------oM---BB-M---MX----M----T------oE-------X-T------BB--E-----|---E-M-------EM-o-E--Eo--X-E----|-?--ME---XM---E??o-MB----|--------o-----?--------------------M-B---T-T-B---Tf-
-E--M-----TB-----------o-----?o---|-XX--o-XT-------o-----Bo?---Xo?-XT-------?----B-M---------T-|----MX-XM-o--o|----B-EoE|-----o--M|XB------B?--------|X--o--?-|-MME---B--EM--B---X-|B----X--BE---|-BoBfB
--|X----|---?--M---|-----o--T-B-B----E--oEM--EB--|-----B-?-TM--------Mo--EMET-B|--|----XB-|X---o--oE-o|?---E--?---EX--------TM|-B---X---o--|------B----?-B-T--M--M?-MXB---|---o--M----E-?B|-TM---o--E-fo
-E---?----M-------|-o--|-X--o-oB---M---E|-|M?----|-----X?-B-----X-oE----B---T-o-MT---M---Eo?B-|M?E--M----?MB---oM-oo-------X-oo---X|--T?o|XB--o---?-|-MXE----E-------X---BB|-E-MM-M-X-?-X--?X|X----M--fX
m-------Eo|------TX-oMMB---BB-B--T------E---T-------?-?-----?------o-----T----XT-ME-T-?-M-X---E---------X-?--BX-?---BM?---B--o--?--E--------T-o--M-BM-Xo--B-X-M---?--o---M---B|M-B-M---------|--||T----E
XXXXXXXXXXXXXXXXXXXXXXXXXXXXXXXXXXXXXXXXXXXXXXXXXXXXXXXXXXXXXXXXXXXXXXXXXXXXXXXXXXXXXXXXXXXXXXXXXXXXXXXXXXXXXXXXXXXXXXXXXXXXXXXXXXXXXXXXXXXXXXXXXXXXXXXXXXXXXXXXXXXXXXXXXXXXXXXXXXXXXXXXXXXXXXXXXXXXXXXX
