-?-M---E--------B-------E----T--T-X--E--E---E-|--|---?---X------------T---X--------|-------X----o----E---T---o--------BB?--------X---------------------------B--E-----X----?-X--B------M---------------|
--|---M-----E--X---|--|E-------------o---?---T---o---T---B---E---------------E---E------|M-----------------|------------?------M---E------------------T----o----B-------------T---M-|-|-----------T----M
--------X---X-------|--o--o-----B--------------M-oTE----o---------------o--XM-M---o---------B-----------------------------------?---T-----M---------------|--?M---E--------E-------------o-----BX--B---M
---------o-|--T----E----------------o---------|-M--------------T|-------------B--------?M------M--?----T---M------T----------B------B---XoB--------|--B---------o--E----------E------||--------X|-TB---o
------?------X---------|-o-|?-----B-------M--------?-------X--X----------------------T------B------------------------|-----M-E?--------B-----TE------------T---------?-----o----B--------------o----|--M
-----------------------------B--------B--------------------E--M----o-----------E---o-?----------------|-------o--?-T-------B-------|--------?o--E-------|?--o-X-------B|-o------------T---X-----B---M---
-------B?-----------o------o--------M--M---o-B--|------MM-o-|-X-X-o----B---X---------------X---o----------|---B------------X--X-?-ET-XX---E-----|-----T----------------E?-M-X----------|---------B-----B
-------------T---o--------T--X--|----|--------------------T---o-B-----E--------------?----E------------|---?---B---BT---------B-----X--Bo----?------|-------------------X---------------------o----B--v?
-o|--To---X----T-T--|----Bo--------------MEBM-E--X-------B-M-----o-------MB--o--TBE?EX--?---T-M-X--Boo?---EMT-M?X|B-----?X----EX--|-oT-ooE---TEM-B---E--?-----M--M------B-EM-ME--?T-o----|---EE-------fo
----------E--E---o-MB---o--MT--E--oMT---|BM-|-XX---Bo---|--B---X---Mo--o|---E-X|--|-M-E-?-------o-o------E--X?--------|-?B-|---o---M---M-|-M----TTo-??o----oBXBX-o-M----XEE-Bo-oo|-X?-T|oX----EE--X--EfM
---o-|T-----|-M-B--XE-----------To-----??-?--|T----T?-T----ETT--Eo-----M|M-MTB---XM-?E-?--------?-MT-EE--X---BB--o--M-B?|--EoE---X-BM----XEE--?--X-----T----|----o-o-------TMMB--E-|B|oB------B?------f-
--B-B?MT-?--?--o---oo---|-o----o-----M---M--?----XXX|-T------o-E------M|--X|BX--|-TX--|---|??--TT--BT-o----X----TETX-|B----?|---|-T----Mo?-M------o---M?-T??o------B----|--oTT-B|-----T-|-----Bo----MTf|
----|-----B---T-?----------X-T---??---X--------E----Xo---?-------X--|?----|MM-----o--------|B------------E|-o-X?o-B--EX---M|------EB-MX|--TM--------XX-------T------?-o--T?-E------T-EB-?o------oX----fM
-B-X---B--MTM-------|-BE--E---B---o--------E---BX-------M--|-MX-o?-T-----|-?|--|-|X----B---oM?-------|-M---TM|-M------oo---o-B-------|E--M---oB-T--X-ETTMB-?B---BMB--|X----XX-----ME-|E--T-----E-X----fM
mX-o----BT-BX---|B-----X--X--?--?--X------X-||---B-oTT-T----X-B-B|-X---?-o-XM----|---XM----|------X-B--?-|--o------------E-E-BTEE-X-?---------EEB--B?T-|X--E-T----|-----?--B--TB------T-E---M--oM-E-o-?B
XXXXXXXXXXXXXXXXXXXXXXXXXXXXXXXXXXXXXXXXXXXXXXXXXXXXXXXXXXXXXXXXXXXXXXXXXXXXXXXXXXXXXXXXXXXXXXXXXXXXXXXXXXXXXXXXXXXXXXXXXXXXXXXXXXXXXXXXXXXXXXXXXXXXXXXXXXXXXXXXXXXXXXXXXXXXXXXXXXXXXXXXXXXXXXXXXXXXXXXX
