---------o----T--------------B-----T-?------o-----------------o-----E--------|--E----oX----------o-T----B---M---------------|---------------T-------------------------|M-----B----E---------?---|-------
----T--------X|----------|--------T------------X---E-------------oE---?--o------------o---M-X-----B|----------M--?---------T-------B---------E--------------T?------------B----?--|-X---?---|--------T--
-------M-----X--|---o--B---B---X--T----B-----------?---------T--E---M--Mo--M----------------------------------------E------------------E-----B----------?---?---E--X-----B-----T--o--E------oB---------?
----------M----B-----T-T-----|------------o--------------------o----|--------------T---------X------------------B----------M----------------EB---|--T----o-----o-------BX-?---o?-B---o-----------------T
-----?----------T-E------------B--E------------X-------------X-----------X-|-B------|--B------T-M-----|---?-B--------------?----------o--MBXX---B----------------X-----M-?-------------------------X---o
----------|------E-----X----------o-----|-----------|---B----Bo--?BX-----------M---------E--o--X--------E--------------T-X-----------------------X----------------------oMBE------B---E----------------E
-|----------|------|-|--------------M--------------?--B----------T--B---E-----|--o------|----E------------E-----M----------|---------E-E----E|--o------Mo----o-B--Bo------------|-----------EE---|?----o
-----------B-|---E-----T--------T-----------?----|-E-------------|--o------------------T---T--o---|-----------------------------?-E----B-----|-B----------?------------------------?-------X----------vM
---BE-E|--XE---X-E-MB-o--??-----EM-----?-------|--oXB---|---E-o--oB---|M-ME---?-XM-|oB-B-E-T------------X-X-E-T----M-X-|--ET||------oo-M|--B-X--X--M---------------?--|-X---o---B-------B--B-?o-o--|--fB
-------B-EXTB-o-|X------X--?M?-T-X|-------T---M--B---?---M-X-oo-|To|-oT---T-|--?---o----BE---TT--M-----?-X-----?X--oB---B-T--MMM---E-o-X---T----BE--?X---?-----oo?------T?--|-X-ToX---|BT-?-|---XE-oo-fT
-----T-EB--M-?-o----T-||M-?----o----XE-E-X--------EM-?---EM-----X---T--T--T|---oT|-----------B-TE--|To-E-Mo-----------o-X|--X--?-T-?--X-?BEX-o|M-|---X??-?--B-oX-ET-T---M-------E---E--T--BB---M-EE---f-
-o-ETo--E---X---X-EX-|-B---EE--B---X------T---------X-|--Mo--|-|-oT-oT-o-----E---|-M--------X?----XBB--|M---?o-----X-|-M-B-T-X-----TB?T-?-T-?|-----E-BB-------X-----T---X-X-----o---oM-E----o-E---|---f|
--B----M--T-----|BTBM----o|T------X--B-MBE------EX-|-E-B|X--------B--B-------X----------|---?---?M--E---|-|-?-------M--B--M-B------oE-B---TTo?--M?-X--?-o--E-|------|M-|-|--M-------------XB---B--M---f-
-|?o|XE-?--------?----o-oB-X-----MM----X------o-X--X---|-oE-X-EB|------?----B---X-------M-----EX?-E||-MB-T-oB-M--?oT-B?Eo----o--M--X-EX-|?-M|ET-?-------MoX---o-----T-E--M-M-BE----T-E-M?|o--X|-?|-B--f|
mT-B-X--MB------B|?-B-M-B-TMEoE--MX---E----|M-XM?-X-----------B--BX-Eo----M-E-Bo?-oX-X---o---?-B--|-E?--|-X--E-??oXBX----B--X-E------TTB----?---M-T----E--X-X---E---BB-MM-XB---?--X?-|-----MM--M?-----T?
XXXXXXXXXXXXXXXXXXXXXXXXXXXXXXXXXXXXXXXXXXXXXXXXXXXXXXXXXXXXXXXXXXXXXXXXXXXXXXXXXXXXXXXXXXXXXXXXXXXXXXXXXXXXXXXXXXXXXXXXXXXXXXXXXXXXXXXXXXXXXXXXXXXXXXXXXXXXXXXXXXXXXXXXXXXXXXXXXXXXXXXXXXXXXXXXXXXXXXXX
