-----------X----------------------------------------------X----------BBBBBBB--------------------------o--------------?----------------------------------------------------------------------------------
------------------------------------------------------------------------------------------------------------------------o---------------------------------------???--------------------------M----------
-----------M--------------B------------------------------------------------------------------------------------------------------------------------------------------M----------------------------------
----------------------------------------------------------B--------------------------------------------------------------------------------------------------------------------------X------------------
------------------------?--------------------------------------------------------------T----------------------------------------------------------------------------------------------------------------
------T---M----------------------------------------------------------------------X-----|----------------------------T------------X----------------------------------------------------B-----M-----T-----
------|----T---------------------------------------------------------------------XX----|----------------------------|-----------XX-------XXXXXXX-------B------------------------????-T------------|-----
------|----|-------------------------------------B-------------------------------XXX---|-----------------------B----|----------XXX--------------------------------------------------T|--------X---|----v
------|----|--------------------------------------------------T------------------XXXX--|----------------------------|---------XXXX--------------------------------------------------||--------XX--|----f
------|----|-----------X--------------------------------------|o-----------------XXXXX-|----------------------------|-----T--XXXXX--------------------T----------------------???----||--------XXX-|----f
------|----|-----------XX-------------------------------------|------------------XXXXXX|-----??---------------------|X-XB-|-XXXXXX--------T-----------|------------?----------------||--------XXXX|XXX-f
------|----|-----------XXX-----------------------------B------|------------------XXXXXX|----------------------------|-XX--|XXXXXXX--------|-----------|-----------------------------||--------XXXX|----f
------|----|-B------?--XXXX--------------T--------o---?-------|-------------B---XXXXXXX|X---------------------------|XXX--|XXXXXXX--------|--------o--|X----------------------------||--------XXXX|X---f
--T---|-T--|-----------XXXXX-------------|--------------------|------------------XXXXXX|XX--------------------------|XXX-X|XXXXXXX--------|------BBBBB|XB---------------------------||--------XXXX|XX--f
m-|---|-|--|---E---E---XXXXXX------------|E---E--X------------|-----------E-E----XXXXXX|XXX-----E--------------EE-EX|XXXXX|XXXXXXX--------|----------X|X------E------------------B--||------E-XXXX|XXX-X
XX|XXX|-|--|------XXXXXXXXXXXX--XXXXXXoXX|XXXXXXXXo--------XXX|------XXXXXX----XXXXXXXX|XXXX--------XX-XX--------XXX|XXXXX|XXXXXXXXXoXXXXX|XXXXXXXXXXX|XXXXXXXXXX-XXXXXXXXXXXXX-----||-XX-----XXXX|XXXXX
