-------EM---E-?-----------B------o---M----B---?---B---------|-M------o-E----?--------------------T----T---?------------M--------?---?----o----------M------------|---------E----------------?----------?
----|---------T--?----------|-------X---|---------B------T-------------o--------o-----------------?-------E---------------T-----M--o---------o--T--------o--------------M----------------MoM-T------X--B
-----T---B------------E------------------|-----o---MB------oE-----M-------B--X---E-------?----X---------|?--?---------E-?-------------?------X------T--------o--E------T----------E--------------------M
----------------------X------------------o---------T---------E--------X-------------o-------------------B----|------E--------------------------M?---------oT-|----T--------------X---------------------|
--------------X-----T----B--T----------------------------|M---------?E----------E------E-----|-B---o-o------M-------E------------------------X---?-------E---------X|---o-------------E------?-----X---T
-?M---X----M----------oo-----|-E--------?----B----B-|-o-----------------E------T----o-|---XE--------------|----o---?----------?----------------------------o---E-o-------T------o---------------|----E-?
-------------------------------E-----------------------------------------|------T-----------------------T-?-----------E----------B-M-----------|---E------------|--B---------?---oB--o---M--------------
-------------E---------?---B----M--X--------------------o--------------------------T-------------E----------?--X----Mo----M---E-B--|---oE-------------?-------------|-|-----|-------------------M-----v-
-|MMTB?----o?--------------X--X-----M?E?--X---?|-T--oT---|--E|--?---X-T--T-----MMo-TE--X---M-B-------------?-|X-X-MM|--------TE---MT---X|---B------?M-o||---------?-----X--?E-|--T-?-o--M-XXo-|--B----f|
--|--B--T-T-X-|-X---?-|-----XBEM?B-XM|-XM-?--MMM-TB-T--T--|----------MM--E---?--|--o--?MM----|-BM-|--E--o-X-o-XT-|----T-----o--?----|--M-o--E---|---B--B-?BX------M-------?--o-|B-M-|--------E------?-f?
--|X----------o?M---MX---------M--E----TB-XB-oB|--X------TM----X----E-BXo---B-ToM---X-?oE-M-|EE-BE?--------o|-T-E-----ET-X---E--E?-TX-B-E----?XM-o-?--E---T--|ET--|-------BT--?----X-?---oB---o-X-X---fB
-X-|B-------------BE--------MXT|-X-T-|--?-T?--?-|-----E|--X----MT--?----B-M-----B?-----|-?--oE-M-E-M-E----T---?o-ooX----E-----o----E-oM---B-||M----Mo--|XM--?-E-E-E--ET-B--BX------o-Xo----oB--?---BMBfB
--M--|--T-XXMB-B-oT---oX-----o|-T-EE-o-oE--ETX----E|-X-?B---?o----o--|------?-o---?--o-----BB---?-X----o--B-|---BT-?---o-----oTBB-E|--------T-----------|-|--MT--T---TB---E-o-----B-|----M-T----M--E--f|
-----------o||-----E?----XT-E----Bo----|-M--|----TT-----XM-------|---M--|-M-E---T---?--|?|-B----|--?-?M-T-E-----o-BXX?---oo--B-X-?--BT----B-------|---T----?-----E---------M--MM?--------o---To-o-----f-
m--o-BB----oTT-E--T--B-To--X--M-E-T--o---E-|-E-XEBE?--?MX-o--M?-o--?----BE??oo-------?-|-B|B-o---------B-----T???--MM--B-----E-o-----T-----M--X------EB--------oBX--B?X--X-|B-------B--EE--X-To--T?--X-T
XXXXXXXXXXXXXXXXXXXXXXXXXXXXXXXXXXXXXXXXXXXXXXXXXXXXXXXXXXXXXXXXXXXXXXXXXXXXXXXXXXXXXXXXXXXXXXXXXXXXXXXXXXXXXXXXXXXXXXXXXXXXXXXXXXXXXXXXXXXXXXXXXXXXXXXXXXXXXXXXXXXXXXXXXXXXXXXXXXXXXXXXXXXXXXXXXXXXXXXX
