--------------------------------------------------------------------------------------------------------------------------------------------------------------------------------------------------------
------------------------------------------------------------M-------------------------------------------------------------------------------------------------------------------------------------------
---------------------------------------------------------------------B-----------------------------------------------------------------------------------------------------------------------------o----
-------------------------------------------------------------o------------------------------------------------X----------------------o------------------------------------------------------------------
--------------------------------------------------------o-----------------------------------------------X-----------------------------------------------------------------------------------------------
-------------------------------XXXX---------------------------------------------X----------------------XX----------------------------------------B-----------------T-----------T------------------------
-------------------------------------------------------------------------------XX---------------------XXX--T--------------T----------X-----------------------------|-----------|------------------------
------------------------------------------------------------------------------XXX--------------------XXXX--|--------------|-------------------------?--------------|-----------|-------------------X---v
-----------------------------------------------------------------------------XXXX-----B-------------XXXXX--|---------T----|----------------------------------------|-----------|-----------------------f
----------------------------------------------------------------------------XXXXX------------------XXXXXX--|---------|----|----------------------------------------|-----X-----|-----------------------f
-----------------------------------------------------T---------------------XXXXXX-----------------XXXXXXX--|---------|----|-------X?------------------------?------|-----------|-----------------------f
-----------------------------------------------------|--------------------XXXXXXX----------------XXXXXXXX--|---M-----|---?|?????-XX-------------------M------------|-----------|-----------------------f
-----------------------------------------------------|-------------------XXXXXXXX---------------XXXXXXXXX--|---------|----|-----XXX------------------T-------------|-----------|-----------------------f
-----X-----------------------------------------------|------------------XXXXXXXXX--------------XXXXXXXXXX--|---------|----|----XXXX------------------|------X------|T----------|-----------------------f
m-E-XX-------E---------------------------------------|-----------------XXXXXXXXXX-------------XXXXXXXXXXX--|---------|----|---XXXXX-----------E------|-----XX-E----||----E-----|------E------o---------X
XXXXXXXXXXXXX----XXXXXXXXXXXXXXXXXXXXXXXXXXXXXXXXXXXX|XXXXXXXXXXXXXXXXXXXXXXXXXXXXXXXX------XXXXXXXXXXXXXXX|XXXXXXXXX|XXXX|XXXXXXXXXXXXXXXXXXXXXXX---|-XXXXXXXX----||-XXXXXXXXX|XXXXXXXXXXXXXXX--------X
