-T-E-----------M---------X----|--------|XMo--------?---------o----X--------------|?E--------------M----------?---M---------o------?---E----o-o----------------------------?-------X--o-------o-----E---o
---------?----o-T-----|----?|T-------------------?----------E-|T---T?-----EE-----|---T---|-------------?--E------X---------B---To----M-------EX---------E?o-----E-----o--|-M-------M---E-X-------------T
-------o----?--o-M----M-------------------------------o-E--------B----|-----------|-T-------M--------------o--------|---T---B----------T-----|--|--------------------------------------------B-E-------B
--?o---?M--------MM--E-o-------B---------B------------------------------------BM---------T------|---|---------B-T--E-----------------o--o--X-------------------------TE--------------------------------?
-------ME------o-----------------?-------------TB--------o-----|-----E----------X|----------|-B------------o|-|--------|------M--------------E-----------M---------------|E|-----|--------E--E------T---
-----B------------------B---o------B--?--|-------X----------?---------------------------------B---T-----------------?EB-----o-----o-----?-------E-EX----------o--?-------M----T?-----|-----------------|
-M-------------o---X-----M---------TB--?---------------------T---?--o------??T-M--?----E---?-E----------?----E-?--------?-B------|?----------------------?MB--------T-------o-T---------M-o-----T-?-T--B
----|------|-------------o-T------|--o------X----M--E----------|-?-----o-?----|----?E------------T-------------------------?--------o--o--E------?----------------------|--o----B----?E---M?---E------v|
---?-----MT--M|------|-T--B-|--M-MT-|--T--|----------------B-X--M------E|--X--T---------|?-X?-M-o?---TTT?-----|--T-o-B?--oT----M--oX-XX-Too|--E-oX---|----o|----T?BBX---------E------T---|-E-T-o--E---fo
--o--B--M----XoEB----T----|--XX-ET---|-TT-----B-M------BB-o-------T-T----------?X------------B-----X-B--M---o---------oT-|--Mo------------X-----EM--B--ME-|--------|TB---oo--X--|--X---BT-X----o--E--|fB
-B----X--------E--B----------?-XBM--?---------oX------E-X----T-EBE--------|o-----?---?---X--B|E--|---X--B---B-B??--M-o-----B-?|---|TX-----------E|-?-|-o------?EX--MTMX-----|---|---XTBM?--T?---B-EMo?fo
--------E?-MBX-oX---T|-----M----M------MX----E--Mo---EX-----o-B-X-X-MB---M---E--------XX---oX-EE-T|-MT|--T---|----oM-E-M-M|--oX-X-M-T--ET-?B---BBE-oTT--?B-|--B-?o-B------X--X-----------|-T-----T----fE
----o-?B|---MTB----oTBX-E-B---------X------------ooB---E--X?M--o-M-------T-T---?-|-M-----M-M-|EB-?-oT-Eo?-|-|--ET--oo-?-----B--X---?--M--o---?MEME--X---BX?E-|-|MM--?-?-X-----E-----?-o--|?-X-oX-E-E-?fX
-EME-E-?-?o-?-M-?----|B-------X----TX--?------??X-E-T-X------X-?-|B|-B-??-M---E----E------|---------M---XX-BBB--BoX---Xo-E--BTE-MXBMX-BM--E------?XE---E------o-M---T-E---?-B?---E-o--oX?------|T?---?fE
m---X----M?-----T----M-?--BX-oX-E-M-------B--o-E--X-M-B-|-M-BM-|--|---|--EB---X---M---?-?o----|--|--------?---oE---E--M----M-EX-----|--MBE---------X--XM---?|EX-E----MTT----Bo--?------M--------|-B|---?
XXXXXXXXXXXXXXXXXXXXXXXXXXXXXXXXXXXXXXXXXXXXXXXXXXXXXXXXXXXXXXXXXXXXXXXXXXXXXXXXXXXXXXXXXXXXXXXXXXXXXXXXXXXXXXXXXXXXXXXXXXXXXXXXXXXXXXXXXXXXXXXXXXXXXXXXXXXXXXXXXXXXXXXXXXXXXXXXXXXXXXXXXXXXXXXXXXXXXXXX
