------------------------------------------------?---------------------------------------------------------------------------------------------M--------------------------XX-----------------------------
-----------------------------------------------------------------------------------------------?????----------------------------------------------------------------------------------------------------
--------------------------------------------------------------------------------------------------------------------------------------------------------------------------------------------------------
--------------------------------------------------------------------------------------------------------------------------------------------------------------------------------------------------------
-------------------------------T-----------------------T----o--------------------------------------XX------------------------------------------------------------------------------------X--------------
-------------------------------|-----------------------|-o------------------------------------------------------------------------------------------------------------------------------XX--------------
-------------------------------|-----------------------|-------------------------------------------------------------------------------------------------------------------------------XXX--------------
-------------------------------|-----------B-----------|------------------------------------------------------------------------------------------------------------------------------XXXX-------------v
-------------------------------|-----------------------|------------------?X?????-------T--------------------------------------------------------------------------------------------XXXXX-------------f
-------------------------------|-----------------------|------------------XX------------|-------------------------------------------------------------------------------------------XXXXXX-------------f
-------------------------------|-------X---------------|-----------------XXX------------|------------------------------------------------------------------------------------------XXXXXXX-------------f
-------------------------------|------------------T----|----------------XXXX------------|-----------------------------------------------------------------------------------------XXXXXXXX-------------f
-------------------------------|-------------X----|----|---------------XXXXX------------|----------------------------------------------------------------------------------------XXXXXXXXX-------------f
-------------------------------|-------------XX---|----|---o----B-----XXXXXX------------|---------------------------------------------------------------------------------------XXXXXXXXXX-------------f
m-------------------------E----|-------------XXX--|----|-------------XXXXXXX------------|-------------E----------------------------------------------E-------------------------XXXXXXXXXXX-------------X
XXXXXXXXXXXXXXXXXXXXXXXXXXXXXXX|XXXXXXXXXXXXXXXXXX|XXXX|XXXXXXXXXXXXXXXXXXXXXXXXXXXXXXXX|XXXXXX-XXXXXXXXXXXXXXXXXXXXXXXXXXXXXXXXXXXXXXXXXXXXXXXXXXXXXXXXXXXXXXXXXXXXXXXXXXXXXXXXXXXXXXXXXXXXXXXXXXXXXXXX
