-----?------B----E-|?------M--------------|--------------------------E-----?----------B---X---M-----B---X----------------M-------------------o?---o----B-T---X--X----------------?-----B--B-------?X---o
---------o------------E---E?----------M-T------------------o---------T-B---|---EEX-X--M-----------------|-------------M----------X-o-B----------------T------?----------o--------X--B------------------|
---?--------?------X------------M---o---E---?--------M---T?--T-------------------E----------------o--|----T------M--------TM-E----B---?-BT----|--------------M--X---------M------E----?-----E----oB----o
---------------X--oM--X-|----E-M--M----M----X----X|-------------X-MM------------B------M---?--M---B-o------M-------B--M------------------M-------------------------------B-------B--B-------X------E---B
-?---E-B--X-----T-----------?M-X-------?-----|E|TE--M--?----------------------o---------------EX--------XB---o----X--TM-o---------T-----------X----X-----------------M----------------------|-|----M----
------------BBT----------|-----T-----------o-------------------B--------?----------?--X-E-------o---E------------X----o-----M--T-------------------------------E---------------------------B-B---------?
--B-B|?----------------M------------------M----M--------------------|----B---------?------M------------B--oX---------------------o------------|--------E--M--------|---B-----X--------------|----E-|---X
---M?---------------------|--------------------B-?E----------X------B-------E--T-----------o-----B-|-M-----E-------------------------?-----o-----M-------M----------------E---------------------------v-
--?-----E-To-T|T---X--?T-------TB--------?--|?BM-|-----E----|-----TE-o--E-MB-E-T-----X---|--M--B-o--X----M----TB--E|?E-----|-X|-E-|---M----ET-M-------B-??-BM---o-B--X--E|----T?----oX----M------M---|f|
-TTBE-ET-XM|--o?-?----MB---o-o----oX--------M--TE-B-?-----?-E-T-B---EX?---T--|E-?X--?MX---o?--X-------o----|-M--?T--B--o-BT|?-----M-M------M?-|M-----??-o-?-B-BE---o---T----------|-X--MTo----M-T--B-|fT
-B-o--TT----|---E-B------?-------|---o----?-B-BTB--M-oM---E-T--B-|EX-TBo|?E-----E---B---T---?T--?-M--?---TM---X?-|Bo--M-MM-T----T-----X-B---X-----TM--XM?---T-M-X--X----M-?-----oo---E|-------X---E---fE
----?M--?--XB---M---|---M-|--------M-----TXB--?---o|----E-----M--XBT?--------T-X--o-------M-BM-o---------M----o-TBo-B----EE-X-T----?X-o?------M---?------E|-----|--o-B---oT----X-?--?B-T------------X-fo
---TXT--E------X------E----|M--M----oEE--B------E-T---M-----B----?XT-X---oM-B|--X-B----?--o-M-T--|-----M-|-E--B-oTB-|-E--M-?--Eo|B---X--oET|?--?B---?----??E-o-X-T-M------X-T?|-TT-oM-EB-M----oB--X--EfB
-T|--M----|---BM-----------E?X---B-----B-o-------E--|--M---?-----T-o-X---?---?|---Eo---?E------B-------|----MB-?|T--?--E-E---|-X-Mo---T--X-o------??-T-?----M-T--?BM-B---B-o---o?--|-TE?--?T-T---To-X-f-
m------?-----M-T-EB----o---X-?-X-|---Eo-?-X?-------?E-TB|-|T--o----B---oB-?-----X--B----T|X---|---X--|---?|--o--B---B-o--oB-EE-X-T--------MX-M----EB--X-T--o--XT-T------BX-Xo----?-T---T|------oo-----M?
XXXXXXXXXXXXXXXXXXXXXXXXXXXXXXXXXXXXXXXXXXXXXXXXXXXXXXXXXXXXXXXXXXXXXXXXXXXXXXXXXXXXXXXXXXXXXXXXXXXXXXXXXXXXXXXXXXXXXXXXXXXXXXXXXXXXXXXXXXXXXXXXXXXXXXXXXXXXXXXXXXXXXXXXXXXXXXXXXXXXXXXXXXXXXXXXXXXXXXXX
