-------------X-----------------T----TE------------------o-----?----------?---------------B-----T-?-------|--------o-|----E-X--B----------E-?------------------------------M-------M--------E---T-X---X-T
-|----M---------------------X-B-o-|-o--------M-----|-----------E------T------X-T-------------------------------o---|-----|--B----------------------o----B--E--------o----X-E--?--E--X------------------o
-|----------E--B-----------?--------------E------------?-------B----B-------------------?|-----X-------T------------?-M---BM----E--?-EB---------------T------E----T-----??---|--------o----------------o
-M-|------------TE--|---------T------?E----------?-----------------B----M-------E--M-T--EBX--------------o------E-XM------|M-----------------M--M-o-----------M-E---------------?----?-----------ETE---M
------o--?-B-|------------M----T----E---------------o-BBT------------|---E------T?------|----------E----B--------M---T----X--T--?--------B-------------------------B----T--------------T--------B------o
-------X--E-----E------------X|BX------------B-B------------------------------------X----------?-----X-----X-------E-------|--------------ET---?o-----------MM--E-B-B--------B---------------------o---?
----o---------M-M-------------X---o--------------------?---X-----------E-----T----o--B-------------M-----BE-----------------oM-----T----------B------|----------o-o-B-----o---------Bo-----------------E
----------------------------T--------------------o-------T----TE------------------------------B---|--------E--------------E---?--T---|----X-E--------------B?--------------o-------------------?------v?
-B|-?---E------EB-T-B-|E-----B--?-----M-?---X-?-oE-X-E----?BX-?T-o-XoX-B---EE---B------?E---XT?|--?-Xo----Bo-------o-M-----|?|--o-X--oT?---MEX-BoM--E-------M|T-XBT---B------Mo-MMT-TE-EX-----T--|ME-ofE
-B-----Eo---|-E--------X--B|---TM-------B--B-B-----X---------o-E--?B?E-o-TE--o---M-B?--|X---E-B-B-E?---B|---E-X--oX-------T-X-Bo---B----|XX-------|oE-oo?-o--|BE-|-E?-|-E-EBToX|---------BBM-X--|-?---fE
-T-------BX--|T--M--T----MX---?----M---M----|---Too-?---|--TE----X----EEX-o---XEM---T-T------|-|---E-T-------??BE-B----B-----X---oXB---o-------B-?-T--MTEM-ET?|E--o-T--X--?M-X--TB|T||----T|-XM-|-|---fX
-o-B---E--?-?|EEo------o-T-MXM--B-ETE---E------o|--T----E-------|----o----?X--|E--T-X-E--|-MMM--E-X---?--T--B?---M--?-----M--E-EBT---X--XB--T-|-B-M-M--|---B--------T-ME-------XE-o----E--Mo--|--o?---fM
------|---o---o-?-TX-o---TE-T---M|B--T----Mo--?-?--Xo--Mo----Boo-X-||---B-oMX|X---------T|o---E-M|EBM------------E-X-oo-------B-T--|--------T?-----------B-----------E--||X-?-M--E---X-oT------M-B-|--fX
----?To|B---o-X-M--XE-----M|---X----T-------|B-B----|---||---E-M--|-BE---XM----M-|---oE---M---X--BXTB--------oT--?---ET---T----------XT-o----E--?---o--B--TB--|-o------E-B--B-BX?-----?----o?oB---XBB-f|
m-|--XM?--B--T-M--X-T---BE-----X--?---|---XT-B---M-|---|X-E-XT----|-o--MX?--M--M----------EEo-----?--??-oo-----?------|T-|-|---XBo-------Bo---|---E-------X-X---|M|o---TBX---|------?-X---M---|-EE----TX
XXXXXXXXXXXXXXXXXXXXXXXXXXXXXXXXXXXXXXXXXXXXXXXXXXXXXXXXXXXXXXXXXXXXXXXXXXXXXXXXXXXXXXXXXXXXXXXXXXXXXXXXXXXXXXXXXXXXXXXXXXXXXXXXXXXXXXXXXXXXXXXXXXXXXXXXXXXXXXXXXXXXXXXXXXXXXXXXXXXXXXXXXXXXXXXXXXXXXXXX
