----B-------------------?--------T--EM---?------M--B--X-----B----o-----E------B--X----B---------------B-----------E-|--o--------|-o|----|---E------------MM---------------B|-----|-----T--M------------M
-----------?---------------X------B-?----------TX------?X---T----------------M----X--M----T--o---E-B---B------?------------T--------E-----------------------------------E----BM---B----?E-E------?-----|
---o--M|--------B-|?---------TT---M-----X---------------T-----?---------------T?B------------E-o---T------B?----------------|------E-E------|-M-o---B------------T---B---E-Xo---MB------B------?-------M
---------oo------E------B----|E--------------------------EE--M---------?-------T--|--------X-------------X------|---o---M-------?o--T-------X------?-----o---E----------B--M-----o--------------M------X
--------o----E---B------------------|---------|----o-|-----oo-----------|--------------------M---|-------??-----EB----------B-------o-E---M-------E-E----------------------B-------------------X|----M-X
---B---|-?----------E?--o-------X-----------?---TM----------------T----o--|--------------------M----X----X-----E-------------o--?X--?---B--B---oB-------------?|---E------o--------------------?---o---E
----------------------oX----------------|----X---|BX----?X---B------o-----------M------------?---?--------------------?----------------------X------X---o-------------------?------------B-------------E
-------B-----EX------|----?---|-------M--M---|-------------MTX----B-X------M---------------X--------?----o-------T---M---------------?-------MX--B-------T-?------------------|M---|B-----------E-----vB
--T-BM--BB-T|M------E-----XE-|------M----?|B|-?------B|---E-TM------E--MX-X-E-----o-----------X--B--M-----B-X|-X-E---M--o|-E?-oEo------T-------o--o?------B--TBMBX--X--B--------------E-B---E-T------Ef|
-------------|-BB--M--|M-|---o----o-o-----B-MM----MX?T-E--|--o--E-|--MoBBX-MoTXE|--MM---MX|-----B------?-o-M---------M--X----oE?--T-------E-----T----o-B-?--E------M-E|-MMX---X--MME-?---------||MX--?f?
-MM------M------|?-||--To--T|-|X--?M-----|?-B--E--|E--B---EXE---B--MB------XT--TB---E---M--TT---TX----o--B---B--E--|---M--T----T-B--B-M-----E?---?BM-|---o-B-----?o---|---X--B---E-|--E--XB--E----T--Tf?
-------B?----|--M-----|-T----------B----E?oo---X-------|--MX--------------?--M---------|E---M-------BT-E---E?B?--T--T-X-----------------B?|---ME----o----|-oo---?------MM-o---T--MM--o---|------o----Ef-
----------?E--M----MX--T--o--o--T|M----oX--XX--TM--?----T-E------X--X-X-T-TT-?-B--E-B?--BE-o-o-||B?-----M--T|oMB------M-M-----E--oXX--?-M-MoEB--E-E---TM|--E---E----?T?---MME--|M-o-XT---M-M----?---T-f?
--?----|M-BM-BET--EB-o-|---MB--T-B--B----T--|----M-X---o----B----M---oT---?ET----EB--?E--|ooM-M----?B|-o------XETMB-----T?----XXT---BToE-T|-?--------o--T---|--E---o-X-M----?|---?----B--?----X--M--B-fT
mT-----?---B--|-M--|--T-M-----Mo-TB?E--E|X----MoB---ME---ET------||--E-T|-T-B-|---B-TEX--|----------MXBM|-|-o-------------o-|T-----T----X-X---T---M--E--|-----|XM---EX-------|--X---M-|-B---E---|----|-o
XXXXXXXXXXXXXXXXXXXXXXXXXXXXXXXXXXXXXXXXXXXXXXXXXXXXXXXXXXXXXXXXXXXXXXXXXXXXXXXXXXXXXXXXXXXXXXXXXXXXXXXXXXXXXXXXXXXXXXXXXXXXXXXXXXXXXXXXXXXXXXXXXXXXXXXXXXXXXXXXXXXXXXXXXXXXXXXXXXXXXXXXXXXXXXXXXXXXXXXX
