---E-?----?-X-------------B---X--M-----------------------BM---B-------------------B---|----|------------oE---|M---------?-------------------M--B--X----E--o---------BM--T------------?------B-MMM----T-|
---|B-T-B-----------?M------------M--X--M----------X--M----------?---B--oT---E-|--------E-B-----Xo------------T-?---?----------------M??-----?---------------X-|---T------------X----M------?-----------
-----M-B-----o----Bo-------------------------M-----T----o-----B--X-----T-------------------M---------------------EB---------B------------X--|E------------------M--------------E-B--------?------------T
------|---E--------------E----------o----E---B------T---M--M-----|----------|-T----T--M--E-------|---M---------------?-E-|----XT-T--o--B-----------M---?-T-------o-E------XEo-------o-o-----------TXE--o
----ET--M------------|----------T------EM-----------X--------o-----X--o--B-----EB-B-----------------------E-----B---------------|------X--------------|--To--|-------M---B---------------T-------------|
-----------B--B--T-----------?--?-B-----------------M--|----------------B---??---o---------------?-----ET--X--------------XBo-?------?--M-B--?T-o----T--------T------------------T-M--------------T----o
-B---------------E-----------X----M----------X---------------?---------|----E---------T-?---------------X-----------T---?------?--M-----------T-----B------T?---?----B-------M-------------------------E
-E--------B---------T-----|---E-------oMM--X--------------E--o--------------|---T-------?----MB---------------------------o-----------X----------------o-----X----M----B----------o-----|-------------vM
-|EM--?X-T--B---M|o-BT---o--|-B-o|T-o-MB-?XB--M----||--B?M-----M----o--MX|Bo--XT---o--?M--E----||-TTEo--B-----o|o--?--B--oB---MoTT---o---E?---?--T---E------T?MM-M--B?-TX-------|----E---------o--?-oBf?
---|EM------o|M?-o-------B-o---BE-X-BM-T-E?-X-Xo-o-E--|----X---T-M--|E--??oo----E--|--?M-?--T-?---X-M---?-M--E-----|----ME-MX|--B--|-?---X-M-X-----?MX-T-|---M-|-M|?---?-T-----|--|-To------X------|-Xf-
--E--X?--E|----?-X----X--EE?o?-o-X---?-------oE--B-|-X--M-----?--o-----E----B--|-XB----XT----?B----X-----|T----------M--M------o--?-------XX-|-?--E-|--?T--|M-?--B-o-E---T-|oEEo-M?--T?X-T--T---o-MMB-f-
---o|E-----E-B-?-----M------o--M-XE-|-----o---?B--BB----E-X-EE?TBM---B-?-T---M----T-?-BXX-|--XX---Xo|-M---M-?E--|B----EX---|B-E--E?T-----|-T----MT-ToT----|X---|o-BB--oXMo-MMB-B-|--BoX-EE---------E--f?
------Eo-E----------X-----|X-M?---oo--M--|--------?--E--M---BT--X--TX-TB-----M---oX-E--|T--B--oM----?--X-o----|-B---o---E---T---|XToB--X|-------M-E--E-?--T|-E--?|B--E--?--E-----B----oM-T-|?-M|--X---fX
--|---M----T--MB-------E--M-X--?X---------T---------B-----X--------TX?--?|---T----?B--TE|--------B-M--|?T-----T-B---T?M------------T--To----|E-?|B?--------o-EE--------EETT-|-EXTo-B--M?|---?--o------fX
mM--|----------T-X-BM----?E---?-o|BB-------|B---B------TT-----T-|-|-B-X-------ooBM--?--?-??------M?-M------M----X-M||E-Bo---------|E----T------?|--o-X-M----EX-?---M--TE-XE----T?o---E-To-E------|-M-|Bo
XXXXXXXXXXXXXXXXXXXXXXXXXXXXXXXXXXXXXXXXXXXXXXXXXXXXXXXXXXXXXXXXXXXXXXXXXXXXXXXXXXXXXXXXXXXXXXXXXXXXXXXXXXXXXXXXXXXXXXXXXXXXXXXXXXXXXXXXXXXXXXXXXXXXXXXXXXXXXXXXXXXXXXXXXXXXXXXXXXXXXXXXXXXXXXXXXXXXXXXX
