--------------------------?-oE----M----------E--E------B--------------E-------------M-------------B---------------?-------------o------X-------------?-o---------?-------X------------------------X-----
------------------o----X------------------o---E----------------------------X---------o---------B-----Eo------------------------?--------------X--------M-----?----M-B--------------------o----------o---
----X---o-----E--------EX-X------?---?---------------------X-----------B-----------------o--?-E---E--M------------------o------------------------M--------------B---?----X--o-o---------------E-----o---
------X-----E--------M-----------------XM-------M------o-----------EXM---------------------------M-----?---------XE--------?-----X--------------------------------B-o---------------B-----------M---oE--
-------?-----B---------o--------------------?----o----M--------Bo-------------Mo-----o-----------------o---------o-----B---?o--o----X--------------------------M-------------X-----E------M--o?-MMB-----
--X--------o-B---B--------B-----------------EXM--------------M--??---B---------E-----M------X----?E?---BM-----------------------------------X?-----?----?---E---------o-------------BMo---B---o-----B---
------?--X----------------BE----B-E---?--o----?-----M-----------B------o---------X------------------?-------E----X--B---------------M-------?----B-----------M-----?------------------------------------
-------------------M---o-------B------?-------?----?--------XM-----B-----------------B--BM--X-----------E--M?-----M----------o---------??----------B------B-o-----------o-----------------------Xoo---v-
-XEB------?-EE-------------EE---Mo--Eo---------XM-XM---E-o-o-------EBE---M------B---ME------X-o-B-E?--E--X-?---E-XB-?-M-----E-----MoB---XB---E-B-B---EBE-E-X---M-E-M---MB---o------------E?--Mo--?--Eof-
---oB--oM---EE-M-?--B-o-B-M-M--M--------?----o?---?-X-------oB-o---X-----EE-X-------Eoo--B-------M-XoB---------?---------MB?B-X-?---E----B-?E-X----------Mo-------B?----------?-X-X-?--B-----M-X------f-
-o---o---------E--M--?M----E---E---o-M--?---------ME----XB-??-E--E------------X---------B-E---?B-B--------?---Mo--X-----?-B---X-M------------o?-E--------------E--M---E---E-MM----Xo--o---------o-M---f-
-X-------------B-----M--M---BX--?----MB------Eo---M---?------X-----XE--M------------------?-?-E?M-Eo--o----?--E-------------o-M--E---oo-o--E------M---X------BX-----?-X-B-M--E---?E-X-?-----?------B-Ef-
-----M--X----BB------------E-ME--X-----B---------BB--M--X-E?------E-E-o-B-X--oo--?-?---EE----M-E-----X--oB--?---Bo------B-------------o--------Eo-X----------MB----BM-o---B-o-M---o--E------ooB?X----Bf-
-E--T-?--?-----E-TTT---------B-T?B-M----XTXX--?-?-----?-E-B-?BTTToT?--T----E-M-?XX-M---T-T--XE-TB-X---T-X--M---T-B----B--TBX--------o-T---TTToT-M---EB--?-----T---o---------?T-T----TT-E---T-B---B--BBf-
m---|?----?-T-BXX|||-------M--B|---T--E--|---?-T--ET-o-|----EM|||?|--B|XB----X---?MoEM-|T|B-?--|MX---E|Eo--E---|---T-T---|---T---Eo|?MXX|-|||-|X-MMM-|M-T----M|----M----M--E-|-|-o--|||T-??|-ME-----oEf-
XXXXXXXXXXXXXXXXXXXXXXXXXXXXXXXXXXXXXXXXXXXXXXXXXXXXXXXXXXXXXXXXXXXXXXXXXXXXXXXXXXXXXXXXXXXXXXXXXXXXXXXXXXXXXXXXXXXXXXXXXXXXXXXXXXXXXXXXXXXXXXXXXXXXXXXXXXXXXXXXXXXXXXXXXXXXXXXXXXXXXXXXXXXXXXXXXXXXXXXX
