--------------------------------------------------------------------------------------------------------------------------------------------------------------------------------------------------------
-------------------------------------------------------------------------------------------------------------------------------------------------------X---------o--------------------------------------
-----------------------------------------------------------------------------------------------------------------------------------------???----------------------------------------o-------------------
-------------------------------------------------------------------------------o---------------------------------------------??-------------------------------------------------------------------------
----X---------------------------------------------------------------------------------------------------------------------------------------------------------------------------------------------------
-----------------------------------X---------------------------------------------------------X-------------------------------------------------X--------------------------------------------------------
---------------------------------------------------------------------------------------X------------------------------------------------------XX-----------------------------T--------------------------
-------------------------------------------o-------------------------------------------XX----------------------------------------------------XXX-----------------------------|-------------------------v
---------------------------------------------------------------------------------------XXX--------------------------------------------------XXXX-----------------------------|-------------------------f
---------------------------------------------------------------------------------------XXXX------------------------------------------------XXXXX-----------------------------|-------------------------f
---------------------------------------------------------------------------------------XXXXX--------------------------------------X-------XXXXXX-----------------------------|-------------------------f
---------------------------------------------------------------------------------------XXXXXX------------------------------XXXXX---------XXXXXXX-----------------------------|-------------------------f
---------------------------------------------------------------------------------------XXXXXXX---------B--------------------------------XXXXXXXX-----------------------------|-------------------------f
------------------------------?--------------------------------------------------------XXXXXXXX----------------------------------------XXXXXXXXX-----------------------------|-------------------------f
m--------------------------------------------------------------------------------------XXXXXXXXX--------------------------------------XXXXXXXXXX--------------------E-------?|-------------------------X
XXXXXXXXXXXXXXXXXXXXXXXXX-------XXXXXXXXXXXXXXXXXXXXXXXXXXXXXXXXXX-------?XXXXXXXXXXXXXXXXXXXXXXXXXXXXXXXXXXXXXXXXXXXXXXXXXXXXXXXXXXXXXXXXXXXXXXXX-----XXXXXXXXXXXXXXXXXXXXXX|XXXXXXXXXXXXXXXXXXXXXXXXXX
