----------------------------------------------------------------------------------------------------------------------------B---------------------------------------------------------------------------
-----------------------------------------------------------------------------------------?--------------------------------------------------------------------------------------------------------------
----------------------------------------------------------------------------B---------------------------------------------------------------------------M------------------------------------------X----
---------------T---------------------------------------X---------------------------------------------T--------------------------------------------------------------------------------------------------
---------------|----------------------M-------------------------?------------------------------------|--------------------------------------------------------------------------------------------------
---------------|-------------------------------------------------------------------------------------|--------------------------------------------------------------------------------------------------
-------X-------|-------BBBBBBB-----------------------------------------------------------------------|--------------------------------------------------------------------------------------M-----------
-------XX------|---------B--------------------BBBBBB-o----------------X----------------------o-------|-------------------------------------------------------------------------------------------------v
-------XXX-----|X-----------------------------------------------------XX-------------------o---------|-------------------------------------------------------------------------------------------------f
-------XXXX----|------------------------------------------------------XXX----------------------------|---------------T---------------------------------------------------------------------------------f
-------XXXXX---|------------------------------------------------------XXXX---------o---------o-------|---------------|---------------------------------------------------------------------------------f
-------XXXXXX-X|------------------------------------------------------XXXXX--------------------------|-------o-------|-------------------XXXXXX--------------------------------------------------------f
-------XXXXXXXX|-------------X-M-----X----------o---------------------XXXXXX-------------------------|---------------|---------------------------------------------------------------------------------f
-----B-XXXXXXXX|XBBB---------XX---------------------------------------XXXXXXX---------------B--------|---------------|-------o-----------------------------------T-T-----------------------------------f
m------XXXXXXXX|XX-------?-E-XXX-----------o---------o--------------E-XXXXXXXX-----------------------|----------E----|------E-----------------E----B----------E--|-|----------------E------------------X
XXXXXXXXXXXXXXX|XXXXXXXXXXXXXXXXXXXXXoXXXXXXXXXXXXXXXXXXXXXXXXXXXXXXXXXXXXXXXXXXXXXXXXXXXXXXXXXXXXXXX|XXXXXXXXXXXXXXX|XXXXXXXXX-----XXXXXXXXXXXXXXXXXXXXXXXXXXXXX|X|XXXXXXXXXXXXXXXXXXXXXXXXXXXXXXXXXXXX
