-Mo|----------------E----T-----------E--------M--X-----M--------|------------------------B----Eo--------------------?----T----------B---M--?-?-----------TE-----------------?---------?-X-o------------B
------B--------------------B-------------------?E---?M--M----------T--o---------o----B--?-B--------------------------------|--M---o----?--------------?----?E--------B-E-------o-----------------------X
--------T-|------------------B---------T-----------------B-----------------------B--T--------|----B--------o-X---X----B-E------T----EXT----------X-------T--------------------|--o----------|-----------
--E------o-----o---------E--------|---------------------E-----E-----------X-----------o--E|---X----------M|----X-B|B---------?---T?-M-X-E------?--o----E-----B-o-------------E---o--TT------o--B-----E-T
---X|---M?-|--?----T-B---M-X--X-----------??------------M-o--B------B-----------------|-----------o--T|-------?--------------M-T--o------?-----B------?-M-BX-T---|--M--------------XX-------------------
-----------M-B--?-----------|----------------------M---T----E-B---M-X-T--?--B-?----------------------BB-----X---------B---------TBB---B---X-----------------------o-M?--M------|E----------B||------M--?
--------M--------------B-------------------------------------?---X------------?E--|-------?--------------------|T------X----|---------X---B---?--?----T---T-----T-------E--ET--------B--?-|X---X--E|-o-E
------?|------M----?---E-----o----------------|-o--X------X----X----------------------------------|-------B------------------B------------------------o-----E---|-o----oo--T-T-----------E--------o---vT
--MX----M-o-----M-T-----?------o---B-E|?--------|---|-E-B------o?----T?M--E--X--|------B-o-o-o--M------E-----EX-|--|B|----|---E--E|-|--E-T|T----E---B|XM-|-----M-oT--|-T?B---BM--T-MMM----X|--o-M-XE-TfX
----M-?----B----E--------X----Eo---X---B-T------B?-|-X-|B|-X-T--M---------X---------TX-M-o-|-X?----XE--XXB-oM-|---------B-BTE---E-----X---X--M?MX-E----TB----X----|--oB-|---EE--MBTT---X-?o---------M-fM
-X-|--M---------X|-oX--XoE--T---------|TXM--B-T-|-----M-TEM---oEB---B---------X--?o-T---?------------XE-E--o------B-o----E-E--T---|o-E-T-E---BoE--|---X|--------XXB-B-?-oEM-----o-BE-E-X|-E?--------M-f|
---B--?|-M---|?------B-|---X-|B--|--M-----EM-?-M-?----oo-?-T----Eo---?-----------o--ME--B--E-o----------B--?-E-oBTXX---|-Xo-BX-|--E---X-B-BM-----T---MB--ME-oXTo--oX-oX-ooMT----o--E-B-----?|X-B-----XfM
-XX--E--?E-----o-M-|-?--|-----------ET-------E?T-----|----T-E--B---EX-?---B--------o--M--o-EEX-T|?-T?B---o-X---E---------BB----X---T--o-M--------o-?X--o----?-X-T--E-----X|?--T-|X-o-X------X|--B?B-X-fo
-T-o---XX-----?------?-oET------T--o--oo?-T--B--o---XT---B--|-|-?-|T-B|X---TT-----T------------To--?o?TT-----?------o-?-E---E-E-B-B--------ET---o----M--|?-------X---B-M||-o|---?-E---E|---?---T-E-?--f?
m--B---X--M--X---------------M--MMo-ET--X--?o---------T----------o-?--E?X--EM--E-T--Xoo-?-T-o----?o?T---|------X-E-M-----M--M-B-|--oB-----M--o-oo----M-M?-o?o-E-----X-oo----XTBM-----?-E|----Eo----E----
XXXXXXXXXXXXXXXXXXXXXXXXXXXXXXXXXXXXXXXXXXXXXXXXXXXXXXXXXXXXXXXXXXXXXXXXXXXXXXXXXXXXXXXXXXXXXXXXXXXXXXXXXXXXXXXXXXXXXXXXXXXXXXXXXXXXXXXXXXXXXXXXXXXXXXXXXXXXXXXXXXXXXXXXXXXXXXXXXXXXXXXXXXXXXXXXXXXXXXXX
