-----B---------------------T-----------To--------------?----------------------------M--------X----------X------?--------T--------E--XE-----------------|----E-B-------X?o-----------------o-------?----o
-T-?|-------------?-------E------X-T--M------?-----------o------|------T----E--|-------X----M|------B------------|-----------------B--XoB----|------o--X--T--|B---|-X---T-------------E?------E--------E
------------T------------TXo----------B---Mo-?M---B--T-----X----M-----?---|---------o------------------------------M--------------------------------B-B----||E---M---X------------?---------BM-------M-?
----------|-----------|o--------?------|?|-|--M----------E----E-------|-------------To-------------MB-X-B-----E----------X---B--------Xo------------X-B---------------------o---M-----------------------
----E--E-----B---|----M-------------------------------------------------?|----X-|----------T-------|--------------M----B------M---------o----------|-------M-------B-o--|E------X---o---X----o---------?
----------------------------B------?--o---------?--------------E---?---X----X------XM--o-B?----------E---X--------E------o----M-----|------------T-o--B-------------------------B-------------------M--B
---B-------------------T----B-------E----------------------------------------B----M--o-------|-----Eo-B----M-------T---T--|----------o------TE-----------?-X-E----------M-------B--TM---TE---------T---?
-------B-----------M------|--------------------------X--X----?----------M-o----M-E?--------------BE-X-----------?--X------?-------------B-----------o---------B--|---X-M------------------------------v?
--T--T|--M---------B--o-MT--TE-E---X-Bo?|--|-|--M-X-|o--MBT-B-?-----T-X-----MM------X-BB|M|---?MX-----?--o|To--Eo-----M-o|B-BM-B---E-----XB---E-B---X-------X-E-oX-B|----X--------B--|M-X-M--M--------f?
-B-T|-T---?B?o-T---X--B?---?--Mo------------E|T-X?-----B-------B-T------oM--?---X-X-?--X--------------E---X-?BX-M---o|----|-MX-|o-|---XB--T--o-BX|---X-XXM---??-T-o-----X-X---B--M---MM----Bo?X---o---fE
-M|---?-X--E---------X-M--oE---oT-|--B-M------EE--EX--M---oE--T---?----T|-o?----------------------?-----||----|?-X-Mo------XX?-E-E-o-M--o---X--|-To-M--T-T---?-|---To-?-TM-E-|-M-T?----?|X-o--X|------fX
---B----B---oTo?----T|--o-BT?-X--BM----?--oME---??o------B-M-E-BTo--Bo---|-Bo------E-MXT-o----|-XT-o--?M|MT---X--T-BE--|-E--?--|X--|-|B-E----?EM---o-?--|--|-X---|M??--|B--------X--XT--o?-XE|--|B----fE
-----X---------X----|TT-M-?T--X?MMXTBB----E---?B-oT-TT|----|E-----X-----|----MT-------B------|-TM-----|-|---BT----X-X--M-------|-M-X-T------XoE---|o--TX--------oo--E|?ME-TM--------TM-E-X-X--M---oM--fT
-o|--E-B|-|---??T---|-X-Xo--E--o----B------B-E--o--o-----B--||------------|----EX-?E-TT?X-----------oT-M?--T---o-B--|----T-----TM-T--M-TX--BBo----M?X-?-E-XX-TM---?o--------oE|-Eo-----o-E?-B-oBET-T--fE
m------M--?---T-X|-To--?-E|B-?---?--?-|X----B---EBE-?o--?B?-|-X---------X---E-E---BEBE-?o-T--X-BB--TX---??X--T------EE??-XEoM----??-To-ooo--T--B---X--MM-E-oT-----|-?E-M-o----o---T---B-|-X---X-X?B-EE-|
XXXXXXXXXXXXXXXXXXXXXXXXXXXXXXXXXXXXXXXXXXXXXXXXXXXXXXXXXXXXXXXXXXXXXXXXXXXXXXXXXXXXXXXXXXXXXXXXXXXXXXXXXXXXXXXXXXXXXXXXXXXXXXXXXXXXXXXXXXXXXXXXXXXXXXXXXXXXXXXXXXXXXXXXXXXXXXXXXXXXXXXXXXXXXXXXXXXXXXXX
