----B-B-------Mo----E-----------E----------o-?--------BBE---M--M-----------o--T-------B--------------------o------------B-------|-----XX---M----T-M---T-----------------E--o---B--------T---------------
-----------M------M-----E--------------------X--------M--------?------------X-----o--------oE-------------------------M---?-------------------?X-o---E?----Xo--------T-E------|-------E----------------?
----------|------------B--------?----------E----X----|-----?--------------------EB-T-------o?-X---------?-----E-------------------|ME-----|---------------------M--XE---X-E-------------------B-o------|
-B----------------------B-X----T--E|----------BM----o-------------------?-------------o---------B-E----B--------T---|------TM-------|--B---M-----?---M----------B--------X------------M-----------|----o
-?o----T-----------------M--XB-----T-----------X-------|---------------------o----T-------B--T----------B------T--E----------T-----TE---B-o--E------------B-------------B--M-B-------E----?------------?
---TE---o-ME-T-----XoE---X---------------?---B--|X-----------?------T-o-E--------------T-----------o-o-B|----------------E--------------?------?--------E|-----X----T-----------X----B-----------EE----o
---B-------X-B---------|------T------B--|-----o----------------B--------------------MBE----T|?---------M-----X-------|--------MT------E--------oo-EX-T--------------?----B-o----B------T---------------B
-----------------o----X-o---B-M-----------------M---X-?---B-----------------------o-----|---------------------M-----B|---M----|-|------------------o------------M--------------------E----------------v|
--BB--B-|-T--M----|-|XEMMX---?---o-T---M--|---?EE-BE-T--M---?E---|--T-B------o---|---?---X----EE----?-XM-|E|----o--?-|E-B------|?M--X-----X----X-|M---oTB-M?-XX----M----E-E-X-----o-E----------M-B--E-fT
-----o----T----E--|--E|---M-E---EX-o---?--T-T--B-|---|--|---|-?----oo|E|EE--X---TTTM--T----B---M----|E--TX---------BTX--?--BM--X-?-----B|--oM|-E-T-X---|B----Bo------B-MXo-o|-X------T----T-----M-----fX
--|MM-|--?M--M-o-E-X---oX--X-B?o?----|--|---------X-------|-------X--|X|-B-----B?M-?----XEB-----?-M--B---M----T-----------?----E--M?-------T---T-T------?------?---T--B?--BE-o||B-|B-E--?------------?fE
--M----BE--E---|-?--T----?X----M-X-E---------MX-B-E-o---B-?oE?----|-----?o-----T-oXo---|BT-------T---EM-MB?----?o-MBoTB--|-|MTE?|B-M-B|--T--M----|X-----M--?E-?-XM---B-----E----B-|---T---X---T---BE--fX
--B----E--T-E?-|X|----o---B-TT-T-----T--XM--E-E-o-E--ME--T-------o---------T-o-----X--oET-MEooo-XB--o--X-oTE--Mo-?-----------|-MX--T-----MM--X----|-o-o-Eo-?---o---------B-----?--------|-X----X---|oof-
---B-M------?---B|---|-E---EX-?----o--oTX|-?MM---------To----------o|E---T-B-----X--------B-|----?-ET---T??-?--------E|TTE|?---o?--M-T---B--M--------ET--o-----|------?--|-o--XT---M-------X?--X--T|?Ef|
m-T---oTE-B----TMTX--o---o-BoEEM---X-?-T-?-o--?-o-B?T--X|----oE-T----oE|?--M|----XE--?MoEo|------B---E-E--X-------Mo-----|---E--?---MT?--?-E---|B---ET-T----o------B-----X-T----TX|E--?---E---TX-oM?-X-M
XXXXXXXXXXXXXXXXXXXXXXXXXXXXXXXXXXXXXXXXXXXXXXXXXXXXXXXXXXXXXXXXXXXXXXXXXXXXXXXXXXXXXXXXXXXXXXXXXXXXXXXXXXXXXXXXXXXXXXXXXXXXXXXXXXXXXXXXXXXXXXXXXXXXXXXXXXXXXXXXXXXXXXXXXXXXXXXXXXXXXXXXXXXXXXXXXXXXXXXX
