---------------------------------------------------------o-------------------------------------------------------------BBBBBBBB---o---------------------------------------------------------------------
------------------------o-------------------------------------------------------------------------------------------------------???????--------------------------------------------M-------------??????-
-------------------------------o-------------?-----------------------------------------------X---------------------------------------------XXXXXXX--------------------------------------------?????-----
--------??-------------------T--------------------B--T-----------------------------o-----------BBB------------------------M----????????-------------?------B--------------------------------------------
-----------------------------|-----------------------|-o------------------o------------------------------------------------o----------------------o-----------------------------------------------------
---------------------X-------|-----------------------|---------------------------------------------------X----------------------------------X--------X------X----------------------------------M--------
-????-----------T----XX------|--MBBBB----------------|------???------------------------------------------XX-------------------------------oXX-BB-----XX----XX--------X--?-------------------o-----------
----------------|---MXXX-----|-----------------------|---------???????----------------XX-----------------XXX-X----------------------------XXX-T------XXX--XXX-------XX---------------------------------v
----------------|----XXXX----|-----M-----------------|---------------------------------------------------XXXXXX--------------------------XXXX-|------XXXXXXXX------XXX-------o-------------------------f
----------------|----XXXXX---|-----------------------|-----------------------?---------------------------XXXXXXX-------------X----------XXXXX-|------XXXXXXXX-----XXXX------------------------o--------f
----------------|----XXXXXX--|-----------------------|---------------------------------------------------XXXXXXXX-----------XX---------XXXXXX-|------XTXXXXXX----XXXXX-------------------M-----------X-f
----------------|----XXXXXXX-|-------------------o---|------------T------------------------X-------------XXXXXXXXX---------XXX--------XXXXXXXX|------X|XXXXXX---XXXXXX----------?--------X----------XX-f
-----------T----|----XXXXXXXX|-----------------------|------------|--------------X---------XX------------XXXXXXXXXXBBBB--TXXXX------XXXXXXXXX-|----X-X|XXXXXX--XXXXXXX-------------------XX--------XXX-f
-----------|----|----XXXXXXXX|-B-----?---------------|-----------?|???-----------XX???????-XXX-----------XXXXXXXXXXX-----|XXXX------XXXXXXXXX-|----XXX|XXXXXXXXXXXXXXX-------------------XXX------XXXT-f
m-------E--|----|--?-XXXXXXXX|X----------------o--EE-|------------|--------------XXX------EXXXX----------XXXXXXXXXXXX--EX|XXXX-----XXXXXXXXXX-|----XXX|XXXXXXXXXXXXXXX-------------------XXXX----XXXX|-X
XXXXXXXXXX-|-XX-|----XXXXXXXX|XXX--XXXXXXXXXXXXX-XXXX|XXXXXXXXXXXX|XXXXXX--------XXXXXXXXXXXXXXXXXXXXXXXXXXXXXXXXXXXXXXXX|XXXXXXXXXXXXXXXXXXXX|XXXXXXX|XXXXXXXXXXXXXXXXXXXX--------XXMMXXXXXXXXXXXXXX|XX
