-------------B--?E------------?---------------o-?---T-----M----B---------------T--------?---M-----------M--BE----B--------------------------BX|-------B---B-------------------o-------|--o---E-T-------?
--X---------------E--------------------E------B---E----T--|--------------------o-X-----?--------------|--MT-------?----E--X-----------------------------------|------------|-B-------------------------T
-o---?---------M------------B-------------o---?-------o---TM--------E------o-T-B-------o----o-----o----------|--------E-------|-------?|T---------------E------------M---M-------B--------?|-----------E
-|T----o--------------T-|----------T--------|-oT--------B------o------?----X---B----E------B-----XE---------M-----T----------B------------------E----|-----------------|E----------------------o-------T
---M-X---X---T-MX----E------X----------M----------M------B|-------------------T---?---EX--------E-------------M--------M---------E-----o----------M-----|-----|-----------TB-X----o-----?-----B-|------B
-------T-------o--M------oE-------------T-----o-----M-XX-----BX--------------X-B-----M-E-----T----B--------------X----X-----o--------X-----------B------------?---E--------B---T---T---------?|B-----M-B
--|--------o--X-X-------E---BBX----?-------------------------------B-----------------|----ME--|-----MX----------TT-----T-----------B---------|-T----TX----X-X-------------T------------------?---T-o---E
----o------------------------------------------E-------T-?E---o--------M-B--|-o-----------|---------------M--B---T---oB---M------o--------B-Mo----TM----------B-----?--T------------------o---------B-v?
----TB-oM?B--B-------TM-EBBoo--X--T---------||----oB--XMo-E-o-----XX--M------X-BTM?--E--X-----B?------|---o--To|-----o|E----E--o--XX--M-|M?-X-T-EXB-|Xo-??--oTBM-BBB---X----|---B--o?-o----oM--B---?--fM
-B-E---|-----T-?----B|-ET|-?-----MB---BB|?-M-----EX-E---?XB----B-M--|----X--?EM-E---X---?M-?-TT--B?M--B-------B---X---------?-EB-Mo--M?----T--B---?----B|-----M--|B?oX-o-------B---o-o--------M-o-----fB
-XTo----?-EEM-|-----B-B--T|MTT--T-B-M-E-BEo------E-T---------o------?o----X|T-----------MoX--E----M?---X-|-------||M--BXM---B-BT--?---X-B----EE-|--M--B-XMM----M--oo---B------M---B-T-ET-----M--?-B-?of-
--|M--M------ME--B-o-T-----E----?E------?-X-?-------------oT-E|--|---oB-o-M-?o----?-----E--TTX-X--B---M-T----o-E------M---?o--XX-o|---------E------BX----------B--X-----?--|-o---|-|--E-------|-||----f|
-X-MMEX-|EM----|-Boo--|BTTo--------B-|--oE|-M--XM----T--M-M---o------?o-T------?o-T----------|-X||o-T---|---B--B--T-|o-M--E----M-----M----E??---|-Eo-o-XM-B----------T?--------o-ooMM?--oM----o--B-X--fB
----|--E-EBB?-BT-------EB---E---?TT?oE----T-E-M--oT--T--------o-BM----M|--M-?---EX----|B----o---T-------BE-----TTE-o-T---X---M---------E--o--B---E----T--E|--o-E--o?XMMT-----?---X--o-?-B?M----ET-Bo--fM
mo--|---oEB-X----------?E-EB--BM-B---|-----M?oE----o-TB----TEM-E-?-?--E-T--XoE-o------o--------o---EE|-|TX------o-E--X?oB|-M----B|E---o-T----o----?-o?-B--------T--o----X----E-E--o--BEBo---E-?---XMT--E
XXXXXXXXXXXXXXXXXXXXXXXXXXXXXXXXXXXXXXXXXXXXXXXXXXXXXXXXXXXXXXXXXXXXXXXXXXXXXXXXXXXXXXXXXXXXXXXXXXXXXXXXXXXXXXXXXXXXXXXXXXXXXXXXXXXXXXXXXXXXXXXXXXXXXXXXXXXXXXXXXXXXXXXXXXXXXXXXXXXXXXXXXXXXXXXXXXXXXXXX
