--------------------------------------------------------------------------------------------------------------------------------------------------------------------------------------------------------
-M------------------------------------------------------------------------------------------------------------------------------------------------------------------------------------------------------
------------------o----------------------M--------------------------------------------------------X-------------M---------------------------------------------------------------------------------------
--------------------------------------------------------------------------------------------------------------------------------------------------------------------------------------------------------
-----------------------------------------------------------------------------------------------------------------------------------------------------------------------------------------------XXXXXXXX-
--------------------------------------------------------------------------------------------------------------------------------------------------------------------------------------------------------
----------------------------------------------------------------------------------------------------------------------------------B---------------------------------------------------------------------
---------------------------------------------------------------------------------------------------------------------------------------------------------------------o---------------------------------v
-------------------------------------------------------------------------------------------------------------------------------------------------------------------------------------------------------f
--------------------------------------------------------------------------------------------X----------------------------------------------------------------------------------------------------------f
-------------------------------------------------------------------------------------------XX----------------------------------------------------------------------------------------------------------f
---------------------------------------------------------------------------------X--------XXX----------------------------------------------------------------------------------------------------------f
------------------------------o--------------------------------------------------XX------XXXX----------------------o---------------------------------------------------------------------------------o-f
------------------------------------------------------------o--------------------XXX----XXXXX-----------T---------------------------------------------M------------------------------------------------f
m----------------------E---------------------------------------------------------XXXX--XXXXXX-----------|---------------------------------------------------E---------------------------X--------------X
XXXXXXXXXXX------XXXXXXXXXXXX-----XXXXXXXXXXXXX-------XXXXXXXXXXXXXXXXXXXXXXXXXXXXXXXXXXXXXXXX------XXXX|XXXXXXXXXXXXXXX------XXXXXXXXXXXXXXXXXXXXXXXXXXXXXX?XXXXXXXXXXXXXXXXXXXXXXXXXXXXXXXXXXXXXXXXXXX
