------------------------------o--|-E-----------T----------?--o--------|M-M---T---------------M-M--------o--E------------?--------TM-----o------T---M|-----M-----------|----B---o-----------------------E
----o--B--------------------------------------------------------------|-----M------M-------EBM------------o--M-|-------------------------?B-------------E-------X------------M-M-----X-B?T------?------B
-------------------E-----o|--|----|-------------------------B-X--B----------------T--M------------?-T---------------------M----M----M----------?-----B--MT-----------?-----ooM--------------?----------B
------E-X-------|-------------T-E-Bo-|--X-----E--B---M------EB-o---------T--BM-|-Eo--------------------Mo------------B---------o-----------E-B---B---T--?ET---X-----------o--T-----?--T-X-o------E-----M
-------------------|---M--X-?-M-X-B------------?-X------------------M-------T--------B---o----------|-------M---|----o-?--E--E--------------------?--------X--M------B-----------o---T----------o?---T-?
-o-T--------o-----?-----------------------------M-|-------------------T-----X---B--------?------------?-----o-----------------X--T------B--B-M-E------------------X---T----Eo------?---X----------------
---To----?---------XBM------------M-M------X-------E-o-------X-T--o--?--M--B----------------?----T--?----?-?-T---------------------E---------------------|--|XM--------?---|X--B--E---------?|----T----E
---T-MM----?--E-----------M-----|------------------------------------X-----XM---|-----------M-----X--------------------------TB----B-E---------B----|-------------M-----------o----------X?-?-M----B?Evo
----?o---XB----?--B-B---E-EM------X?T-o--|------TMX-ME-----X-|---BT-B-E?|T----T-oTE--?--B--B--?--Mo-To?E-T?--M-?E--B-oT------------Mo-E-o---?--B?----M|-T-T-oT-----B-T--o---M-B-----|-B----o-E--------f|
-TTo?------o?-----X---M?E?----?|----oXM-----X---B-M|---B-|o--?--|---T--T|-X------M|--?------EE---o|TB-||----X-M-----?-----TB|---?T---|--X--X--E-E--X-----B------X?-----o---EB----Eo--oTB----M----?-ME-f-
-----MMT-X-------E---o-----B|X|ET--M-BMB--|--T------M?--TX-E--?-----o---XE--|--MXo--|-B--------EM----BM--||-Eo-|--X---E-----X??-T--|-|?--o-M-----XEB--E-T---|--oTE??X-M------|E--M---|M---|---M|EBM--Ef|
--MB---X----TT------oM---oX-----BT-|M----B--?-----B---B----BM----|X--B----|---B-oM-B--|E|MM----?T---?-?----------EE----T-o------T----|-o----BE--X----T---E-o---X--T-------MM-----M--?---|----Mo--X--X-f|
---Xo--M--M-----?-BB-----B-----|M|---o--M?----o-------T---TB-ET--TTB---E--------E--T--|--M--MX---E----------X--TBT-?-?--MB-X-E----B-o--M--------?--T-EMEBM--M---TTX---oM-o--E-X?-E-T|M----oo|?-T-X--B-fo
-?-T------E---|---?--?-|X--B-|-|-TXo|-----M----BE-X--B-B?X-oEB---E|o---E?-|---|--T?E--?------oT-E-------B-------oX----|------|--T-M-X--M----o--?--T-E----------M--X--M?TM--BMEB-M--M----X---o--o--B|--f-
m?E---T---XoMB-BM--BB----------?-?XBB---B----EMB--|----X----EM--o----|X--?----oM--o-BB-T-?------T-?----EM----B------B-?|B-------M--o----oo-----B--BoTTEE-XTXM-E-EX--?-B----XMB---|--T--M-E-To---E--X---M
XXXXXXXXXXXXXXXXXXXXXXXXXXXXXXXXXXXXXXXXXXXXXXXXXXXXXXXXXXXXXXXXXXXXXXXXXXXXXXXXXXXXXXXXXXXXXXXXXXXXXXXXXXXXXXXXXXXXXXXXXXXXXXXXXXXXXXXXXXXXXXXXXXXXXXXXXXXXXXXXXXXXXXXXXXXXXXXXXXXXXXXXXXXXXXXXXXXXXXXX
