-----------------------------------------------------------------------------o--------------------------------------------------------------------------------------------------------------------------
------------------------------------------------------------------------------------------------------------------------------B------------------o--------B------------------------------------?--------
-------------------------------------------------------------------------------------------------------------------------------------------------B------------------------------------------------------
----------------------------------------------------------------------------------------------------------------------------------------------------------------------------------------------T---------
-------------------------------------------------------------------------------------------------------------------M------------------M--o-------------------------------------T--------------|---------
-----------------------B-------------------------------------------????-------------M------------------------------------------------------------------------------------------|--------------|---------
-------------------------------B-----------------------------------------------------------------------------------------------------------------------------------------------|--------------|---------
-------------------------------------------------------------------------------------------------------------------------------------------------------------------------------|-------------X|--T-----v
-------------------------------------------------------------------------------------------------------------------------------------------------o-----------------------------|------------XX|--|-----f
-----------X---T--------------X----------------------------------------------------------------------------------o---------M---------------------M-----------------------------|-----------XXX|--|-----f
----------XX---|-------------XX------------------------------------------------------------------------------------------------------------------------------------------------|----------XXXX|--|--T--f
---------XXX---|------------XXX----------------------------------------------------------------------------X-------------------------------------------T--X--------------------|---------XXXXX|--|--|--f
--------XXXX---|-----------XXXX-------------------------------------------------------?-------------------XX------------B------------------------------|-XX--------------------|--------XXXXXX|--|--|--f
-------XXXXX---|----------XXXXX------------------------------------------BB------------------------------XXX-------------------------------------------|XXX--------------------|-------XXXXXXX|--|--|--f
m-----XXXXXX--X|XX-------XXXXXX-------X-----------X-E-----E---------------------------------------------XXXX-------------------------------------------|XXX-------------E------|------XXXXXXXX|X-|--|X-X
XXXXXXXXXXXXXXX|XXXXXXXXXXXXXXX--XXXXXXXXXoXXXXXXXXXXXXXXXXXXXXXXXXXXXXoXXXXXXXXXXXXXXXXXXXXXXXXXXXXXXXXXXXXXXXXXXXXXXXXXXXXXXXXXXXXXXXXXXXXXXXXXXXXXXX|XXXXXXXXXXXXXXXXXXXXXXX|XXXXXXXXXXXXXX|--|--|XXX
