---|o-X--------------oB-------------------------------------------B------E----|---------T--------o-o---B--M---X--TBE--------------E----T----------MM-?---ET--T--B--B--------------------ETX----M-------E
----------------E---EB---------E----------B--------------------M-----|--|---------------------M-X-------------------------------------B-B----T---------------?-----------T---------------?-------E-----|
--------?----|----------E----------X-----T?-----X----------X-----?-----------------------|---o--o------|-------T---------|----------XT-------------?B---X--TT-------------M--M-------------------------?
-----M---------------X--M-----------------------X-------?----?E---------------T------------M--T-------------------|--E--|-|---------------------B----M---------B--BT-----------E------------o----o--?--E
-----------------|----E---E|-|------B--MT----------|-----T--?--T-M--?----------o-------------------o------M----------M-----|X-B----T-----------M--T--------E-M--------X------X------------------M------B
-B--------B-B--------------To--B------B-----T---------------?----------------o-X----|------X----------B--T------|---M---E|Bo|--TM-------------------E---|------|-------------------------E----E--------o
-------BToE|---|---T--o-----B-|----|--------X-?-------E----Bo----E-------------B-----T------------E----------------------B--o--------------MT|---B-----X---?-----------o--?---B--o--E--------X---?-----?
----M--------------?----o-------------------------o----X-----------E-------------------o--------B-----?--------------|-|------------oo-------------------T----X---------------Mo?------?--------------vT
-B-BBo-M|-TE-o----B|--|----TXEE-XTE--o|---|B-T?M|---------M-E-----??--E---E-Eo--T-?|---B---BX----E---E---o--o-o--||E--|---o----Bo?BM----T---M------?---B-B--T-o--X-E-X--MXTT--EooTT---BM----E--B--E---fo
------X-E-MX-T-XE--TM---B-?o----XE---X-B-----M----TT--X-E|MX-E-B-----B--||-B-----X-?-----|---X-------BTM---MMM-----------M-----oo-B-----E-E----------------||-T-X--?--|--M---MB----B----|M-------o-ET-fM
--?--------XB-M-----M-o-T?--o|--?o------o-o--|-M--?TXM-----?B-T-M-E?--MX--X-M--oMX-X-B-B--M|---o?M------B-----MB-o--T----------BB--oM-|oB?-T------TB-----|T-M|-MBX---------E--B----?---|------T-T-B-MMf?
-TM--?---TT--M|---EX-|--?|?X?X---E--T|--oM-|---T-TX---o?-|----B-TB------E-----------XM----B-|--?--M-E?--B--Boo|-------B-----To---XX-|o----|-|M|---o-----Bo---||---?EX---XXE---------MX---o-E-----X--B-f?
-BEEE---o-------|--TT---Boo?----oB--|M--X-BE----E---EX|-TT-|?-XBB---T??--?---XB|---o---X-M-E----M-M----?--o-M----X---BTB-Eo----MM---?o--M--oXoT-?-----T-----|?--BTo---M---E------X--|------X|-B?--M-o-fo
--T-----EM-M--BB---M----E?X-------MM---BT-B---E?T---|-E-?----X---X-----X---M-X|o---E----T-TT--o----BoM-E---oT|--oXE?oTB------E--o--E|XBT--XoX-|-o----M------T?T--|----E--M-------|T-EE-o--E----o-----EfE
m----o-B---M------E---M-X-----?--X--M-Bo-X---X-?-M----E-?T-X-X--------oX-T--E-|?---|-|--|----E-T-E--BB-TT-----E-oX----?-------BM--Bo--B--E-M-X---TTo--||--?EMTT-o------T|B-B-M--B----B--o-X-M--Xo---M-B-
XXXXXXXXXXXXXXXXXXXXXXXXXXXXXXXXXXXXXXXXXXXXXXXXXXXXXXXXXXXXXXXXXXXXXXXXXXXXXXXXXXXXXXXXXXXXXXXXXXXXXXXXXXXXXXXXXXXXXXXXXXXXXXXXXXXXXXXXXXXXXXXXXXXXXXXXXXXXXXXXXXXXXXXXXXXXXXXXXXXXXXXXXXXXXXXXXXXXXXXX
