---------------------------------M---------------???????--------------------------?---------------------------------------------------------------------------------------------------------------------
------------------------------------------------------------BM----------------o---------------------------------------------------------------------------------------------------------------------X---
--------???-----------------?----------------------------------------B----------------------------------------------X-----------------------------------------------------------------------------------
-----X-------------o--------------------------------------------X---------------------------------------------------------------------------------------------------------------------------------------
-----o-----------------------------------------------------------------------------------------------------------------B------------------------------------------------------------------------------M-
-------------------B---------T---------???T????------------------------------------------------------------M--------------------------------------------------------------------------------------------
----------------T------T-----|------------|-------------------------------------------------------------------------------------------------------------------------------------------------------------
----------------|------|-----|------------|------------------------------------------------------------------------------------------------------------------------------------------------------------v
----------------|------|-----|--------T---|-------------------------------------------B---------------------------------X------------------------------------------------------------------------------f
----------------|------|-----|--------|---|-----------------------------------------------------------------------------XX-----------------------------------------------------------------------------f
----------------|------|-----|--------|---|-----------------------------------------------------------------T-----------XXX----------------------------------------------------------------------------f
-----------T----|------|-----|--------|---|----------XXXX------------------------------------------------X--|--M--------XXXX---------------------------------------------------------------------------f
-----------|----|------|-----|--------|---|--------------------------------------------------------------XX-|-----------XXXXX--------------------------------------------------------------------------f
-----------|----|------|-X-T-|--------|---|--------------------------------T-----------?-----------------XXX|-----------XXXXXX---------------------------------T-BB------------------------------------f
m---EE-----|----|------|XX-|-|--------|---|-----X-E-o---------------E------|---------------BE--------E---XXX|-----------XXXXXXX--------------------------------|------------E------------E-------------X
XXXXXXXXXXX|XXXX|-----X|XXX|-|--XXXXX-|---|XXXXXXX-----------XXXXXXXXXXXXXX|XXXX--------XXXXXXXXXXXXXXXXXXXX|XXXXX------XXXXXXXXXXXXXXXXXXXXXXXXXXXXXXXXXXXXXXX|XXXXXXXXXXXXXXXXXXXXXXXXXXXXXXXXXXXXXXXX
