---------X-----?-------o---|--------T----------E-------X-----M-E---------T--o---|-T----T--|---------|-----T---------X---------M-------?---B--B--------------------------T----?-------------?-o---------M
---------------------------E-----M--------------------------------E----------B--M--o-o--M----B--X-M----------------------------E--------------M----------------T|-|-----------M------------------|-----o
------M---?---E--X---------MB------E---------B?-?M--------T---E-------o----T--T---?----B--|-----B------X--?-----?B-------E---?----Bo-------------------|-----------------M-----------------------------|
-B----------------------?T---|-------------|------|----------B---?-----------?--E---------B----o------------MT----o-----o---------E---E-M--|----------M-----------------X--X--------B-B-o----------ME--?
--T------------o--B|-------------o------T-----T-----o-------------M-----B-----------?M----------|---E---------M-----------------|-------?--o------------?---------ME--------E-----------E---------------
-T-------|-E----------?|----|-E-T-M----------------E-E----------B-E----E-----X--------------T---------------?--?--TX---------------------M----o-----o--------------T-?-----------B-B----E-B----o---|---|
-----------------?E-----o----------------?------E----------------------E-----o------------|------B-B--B-------M--M------|B------o-oE---------E---------------o-------------------||--T-----?|-E---B-----
----------------------o------?----X-----|T-------------M------E----------------------------|----------B--B----------------M-------MB----------B--?---?TE--B------B-------M-------------X-----M--------v-
--------?XMMX---Bo--X-----------T-|--M-----X-E------o|MM--T-------X---X-?--X-----T---|---E-------?MX-B--E----------X------M------o-BoT----o-o-X----------|---------B-------M------T--B?-|?--T-X-EoT---fo
-----o-|------M-o-T---M-?--X--M--T-X--M--|---------|-B-------?-|-B--MTB-?M-T--T--------X----?E----?T-------??----T-----X-M-T----|-|--|---M-oMB------E-T--?----Bo----B---|-E--o--XB--E--o?-M?B--E--E|-|fX
-------BBX----------------MTM--E---o||-------TT-X---M?B--------T-|-X-T----TX--o-----?Bo?E--E----B--B-|---|-X-X--M---M|E----E-E--o--?--B---E-?XX-M-X------EX-|---|-E--X-M---B|-Bo-----E|----?-T-M-E-X--f-
---MMM?E-Xo|-----X--oE-|--oT----?T--M-------E--|Mo-B--E--T--o--|-M--M---------MToB-----B--XE---------?-?E----MB-?-BT-M-B------|-|--o-TTT-|----XBX-BT-B----E-EEo----o----------oo--|--E-BX-----X---oBB-fB
----------T-EX--E--X-----BEE?---o-M--------E---X|--EToM-TM--Eo--?TM-B--oM?o-------------?-T-Eo--M---|o----T--?----B-B|T-X-------X---oX|---------MT----T---o-T--M-E------M--T-?---BB-|X----------XM|X--fB
---oB--?---X-E-M-T-T----------|E-----oT?--ME---?--M-?--------?M-o|-X---|-???-T------------M---E-----oo---o--?------M-|oToT---------XE--B---T----|--X-T--XT---TEo--X----oM----EM----X---MXMM-o|--E|--TMfE
m--?o-B-o--T-T----?-M--|----|-?T--------?-T|-----B---MT-?---E-?|----T-TX--------oBX--Mo----?-|-T--B-----Bo-??----E?-----T-TT---T-M--M|T--||T-----|--------oE-E---X--||o|----oT-T?M-o-E-M-------T------X-
XXXXXXXXXXXXXXXXXXXXXXXXXXXXXXXXXXXXXXXXXXXXXXXXXXXXXXXXXXXXXXXXXXXXXXXXXXXXXXXXXXXXXXXXXXXXXXXXXXXXXXXXXXXXXXXXXXXXXXXXXXXXXXXXXXXXXXXXXXXXXXXXXXXXXXXXXXXXXXXXXXXXXXXXXXXXXXXXXXXXXXXXXXXXXXXXXXXXXXXX
