--------------------------?-oE----M-------------E------B--------------E-------------M-------------B--------------o?--------------B----oX---ME------------?EM-----?-------X------------------------X-----
-----------------------X------------------o--------------------------------X--------Bo---------B-B------------------E----------?--------------X--------M-B----------B--------------------o----------o---
-M-----------o---------EX-X------?---?---------------------X-----------B--------------------?BE---E--M--B----------------------B--------------B------------------------o------M--------------E------o---
----------X-E--------M-----------------XM---?---M------o------------XM---------------------------M-----?---------XE--------?M---MX--------------------o------------E----?-X---------B-----------M---oE--
-?----------------XB---------M-M--M---M----------o----M--B---E--o-------------Mo-----o-----------------o---------o-----B---?---E-----E--------B---------------------B----------o-B-----------o?-MMB-----
-E--M--E----?-------?-----M-----------------EXMB------------?-----o----------------------?----------?--------------B---------------------o----------------E-------------------------B-o---B---o-----B---
----M----Mo------------XX---------M---X--B-------------M-?---------X-----------------------------------B-?------B-B-----------------E-?-o----------------o---B-----o?--X--------------------------------
------------M----?------------M-----------M---X----?--------XM-----B--------------------BM--X-----------E--M?--B--M----------o---------?--B---------?-----B-o--------------------------M--------Xoo---v-
-----B---Bo---o--E--------------o--EBB--E--EM--E------X-M---E---M-----?XE---BM--E-------------o-B-E?--E--X-?---E-XB-?MM-----E--M--MoB---XB---E-B----o-B--X---E---oo?-??MB---o------------E?--MoE-?--Eof-
--E--o-----X----o----?--?M-oo-EM--------o----XX?---B----?--??----Eo-?------?-o-X?-?B----E------------B-B--MB-o-----?X-M-XE----M-----?-------E-------------Xo------B?----------?-X-X-?--B-----M-X------f-
---oEX---?-------?----MB---E?-B-BX------E--M??M----------E-??-E--E------------X---------B-E---?B-B--------?---Mo--X-------B-----B--?---------o?----------------E--M---E---E-MM----Xo--o---------o-M---f-
----EXE--?-----B-----M--M---BX--??o---oEMX--M-X---M---?------X-----XE--M------------------?-?-E?M-Eo--o----?--E-------------o-?-----?B-------o-B-------oo----BX-----?-X-B-M--E---?E-X-?-----?------B-Ef-
--B-XMBB---o--X--EXM--EB-MM---------?-B-?--o-o-M----------E----E-?-?-oM--M---?----o------X-------E-o?--?-------ME------E----?E--X--oE------o--E---X----------MB----BM-o---B-o-M---o---------ooB?X----Mf-
----oTT-ET-----E-XBX---X---------T---M-?M--B-TET-----XX?--?EMT-MM-T-----T--------T-------T-------X?--X---XE?-TB--B----B--EBX----------T----T-o?-M--MEB-T?T-T----T?-T-----X-?---?---o------X-----X---BBf-
mE---||-E|--oB-B-T---EE--XX-o--EE|--X?-E---T-|X|EMX----?B--oT|-EMM|-----|-T?-----|--BTo|T||-?---MX---EoE|--|-|-----T-T|------T||-|oE?M|X---|?|-X-MMM--M|T|-|--MT|--|M------|XB--oM----------o---|-|-oEf-
XXXXXXXXXXXXXXXXXXXXXXXXXXXXXXXXXXXXXXXXXXXXXXXXXXXXXXXXXXXXXXXXXXXXXXXXXXXXXXXXXXXXXXXXXXXXXXXXXXXXXXXXXXXXXXXXXXXXXXXXXXXXXXXXXXXXXXXXXXXXXXXXXXXXXXXXXXXXXXXXXXXXXXXXXXXXXXXXXXXXXXXXXXXXXXXXXXXXXXXX
