--o---T------o|-----------------------------------T-M----------T?----B-B----------B----o-|--M----E------|----------------------------------|--------B----B-B----------------------------|------------T-M
----B-------E------B---B-----?-------X-T--X------M--B--X----------T---T--------M--------------------o---T---|----X----M------M-?E--------X-------B-----------------------------------?----X---B--------B
------|-------------------X----------M-----?-----|--o--|-----E-----------|-------?--?Eo-------------E-------X--X-------------E----------X---M------X|-----------B---E----------?-----------M------E-X--X
----------T---T------?-----T------------|------EE------------------M----?-------------B-?--?----?---E----E---T----------?--|------X---M------E------X-------------------------------------T-------------
---M------o----B--------?B--T-----o---------?---X--------------?-----|--o--------E---------T?B-----------B---B-----?-----B--------T-----------M----X----M--E--------XX---?-----------o-----B-----o-----?
-------B-----M---------M----------M-MB-o------T----------o-?-----T--?---------E-----X---------?----------E--M-----------B----------Bo-----?------B----T-----E--|o----T----------------------------M--?-E
------|-----o-------------oT|X----o-|------E---------E-----B?---------|--------------------T----?-----X------?--X---?-----------------B--|T----o---MTB--------|--------------------XX|--E-----oBT?---E--
----------------??------------------|-----------?M----M-----BBB|-----------------------------------|-X------B------------------M-------E----------BX---------|T-E------M----------E--?----------------v|
-E-X--o---X-o-?-?-E?--BEX?M--MM---B---Xo?|--o---EEE|?|T----|-T-|---ETX--|M---E---?B---BM-----MT-BTo-|----------|--?T-?B---T-M----X---M--oT-?-----B-MX-----?-E?---M----B----|XT-BE|-?-ME-TX-T----?-|-X-f-
--?----E-|------TT--Eo--E---?-M---E|---oo--BX------|-------?-B--X---------T|---T-o-T--B|--EB--M----ME?E-Eo-XM-----M-oM-E-o---TE----?-|-E-T-E-----E-XoE-T-------??---X-----MTo--X------------Mo----EM-ofE
----------|X---|--MX-Bo-T-|---o|----?--T----?o--BTM-M--M-E---|-M-|---?-T---------T--E-?-----o------M-|--X-T--E----ToT-|-M-----M-----M-|-----E-T--|------M--------------?B------BBB-oM--o----|-E--o-X--fX
----|---M--|ET??B---T---oT--Xo|--o--B-MoTMBM--M--ET----X----?-X---o-|-EX?-E--MBMX--X------X--B---o-M-----M----ET---M?--E-T------X?oTT|------E--B----oT---o-T--------B-TE---B--X-------X-----B-X|-----|f|
----B--EB|E-XMoXT---E-T-----oB|-Xo--E---MX-----?-B--T-BB--T--M--B?X----E?--o-|-TT-----|XM-----T---Mo?-X-o|-?o|X-?--?-----T-E----|--|-TMX-----o||M-X-----X-E-o?-----X-M----M|-----------X-|-EX--?|-?-MXfT
------EXoX--o-TBX-o-----|E----o-----EM-------M-|---------|-XB-|-?------?X-Eo-oTB-T----M-X----??--ME-----o-T---M-------EE---?--o-T------XB--------B-E-E-------E-oXTE|T---o------X-B-Bo-oX--ME----------fE
m-?B-MB--M|--E-----o----|MT-B--T-o-----M|-o----EX-|-?B------|ooo------oX--X---X-?-|-X-MB?oBM|-|--To----E--MXXBEM-E--BM----T-E---o|-TB----BT--XoBBXEEo-E?--------o-E--------|----X-E--X--T-o-M-B?-?--EBXM
XXXXXXXXXXXXXXXXXXXXXXXXXXXXXXXXXXXXXXXXXXXXXXXXXXXXXXXXXXXXXXXXXXXXXXXXXXXXXXXXXXXXXXXXXXXXXXXXXXXXXXXXXXXXXXXXXXXXXXXXXXXXXXXXXXXXXXXXXXXXXXXXXXXXXXXXXXXXXXXXXXXXXXXXXXXXXXXXXXXXXXXXXXXXXXXXXXXXXXXX
