-M------X-----------------------E-------o-------------?o|----T------------------B--B-----E----------------E-----|------------------------Xo----T----------M------------X-------------E---?-------------E
-------------B---------E----T----|------T-T-----o-M------------?-----X------??---|---------E----?-T-----oX---X-------B------|--------o--------B-M--TX|----------B---------------?---------o--B----M----B
-E-----?--X----------------M--M-M-------o--------B-o---------------E?------------T---------o----?-X----EM----------------o-?-----B-----T-o---------|---?--B-|-----M-M-----B-------B--------------E------
-|--------------|---?---------B----|--B-----------------X-E--o-B-------XB-----T----T-------------X------E---X------X-X--------------------B--------------T---------?--E---?---M-----B---------X--------?
-------X-T-----B------MX--T----|---B-o-----------------------------|----B--M---------------M----------B---------T---o------B---------?---------------------?---o--------?-----------------E-----M--?o--M
---E----------o--------E---------o--T-E-E---B-------------|-o--M--------------|---?---B-T-----|--------o------------|--------?---------------M--B----E--------?T-----------?---o--MM----M-----|--------X
-o-----------B--M----------------?----o----------------X-----o-B-X-?----XX-?-ET---T----------------B-|--------------------M----------T?-----------------o--------------BT--|------M--------------------T
-TT-----------X------B-M---------o-------|---?--o----oX---B--|B-?B----B--?-E----?-----?--B--------------|-------?---T-----oE|--------E?-----------------------|-------------BB---E-|E----o-----------Mv?
--EEM----M--M--M-M--XB-E-|-o-----E------|-o-B----?E---o---Xo--XBM-TM-T-o-T----T-------MB-------BT------X--M-|-|-|--|-----o-o--?|-------------T-M-|?-B-E--B---B-B?M-E?T--XoB---?----T-X--o-E-T--------BfM
--E??T--T------|---o-B-ME---------|---X-T-B--------T?XM?o--M-o-M?---B?--------X-------B--------X?--T-----T-E---------------TE-X-o-----XB-B--MX-?BX--?----B-----X-X?--------|B-EE-?-o---EE--|--?B--B-X-fB
---E--T---B-B---|X--XM---XEE--o----B-TM-o|-?M-----XM-X--To---T----|--|-?|------E--|---X--To-----o---o-?----|-------?-|-oM?B----E--?oXo-------B--o-|E--|E---o-o-o--|-TM-|---T--T---|-B-TXEEXE--------T?fB
-???|--o-T-X-o--o--TT---|T--?-EX-----?-T-E-|--?o-----X-T-BM|-?--oE-oB-|?-|-B---|--B-XBo--E?-----------EM--o-M--BET-T-TXT--ET--B--E------------XB|-----T-oEX-B|--TX|MTM----X|T-XE?---------------------f?
--BM------TBXM-TE--|-----X-----o-Eo--------?---XE-B---------M--?T-E-oo----M-XE--|?--|-BBTE-TET?-----|E--X--?-------TM-----|o|o?-|M-E-X--BTX-X?-T--B-----EETT-M?-------oE---EE---oE-E----------?------Xf|
-?-o|E-----|EXMo------------|?|-----Eo--?--E------o--BTTB--M--oEM------|-EM-EB---M--T----M-|---o-EM-----oB-T-E---E-T-X--B-BT-M-oB--T---|B-X-TT----?--E--T--E?|-?----X--Xo---T-T-----E---T--o---------Xf|
mXME-MB-Eo-----oo--X-E-----o----TT|------|-B-MX--?---E-BB|o-------X-X-|--------|-|EM----E?M-----------------|----TB------|o-M-|--BoE-o--?--o-M---o-?-T-|?ToT-----|-||-XM--|oX----X-E------B----E-E-----?
XXXXXXXXXXXXXXXXXXXXXXXXXXXXXXXXXXXXXXXXXXXXXXXXXXXXXXXXXXXXXXXXXXXXXXXXXXXXXXXXXXXXXXXXXXXXXXXXXXXXXXXXXXXXXXXXXXXXXXXXXXXXXXXXXXXXXXXXXXXXXXXXXXXXXXXXXXXXXXXXXXXXXXXXXXXXXXXXXXXXXXXXXXXXXXXXXXXXXXXX
