-T---------------X--Eo-M-----------------------------------------|----------------------------------|--------?-B--------------------?-o--------|T-E-----T---o------M---|------------?-----E------------|
--------E--oo-----------M|----E-------B-|---------B--oE--------------------------------------------------------X---E--------E-----------------------o-------------------------------M?-----------------o
------X---o--------------------B-------BE----X--------X-------------E---??----------------------B--?---------------|---?-B-?--ET------|---------M-----E---|------T-----E-----o----------T?-Eo----------T
------B--------B--------M-------?-----TE-----------X--BE----------|-------------------M---------M---?---------------|-E--o------?----------?------------M-T-E--------------MM---------o-BM--------------
-T--E---E------------------------------------?----------B--------M----EX--------------o------|----X----------X-M----X--------X------E-----|B-------------|----o--TBT-?-B-----M-M--------------M-----B--T
-------------o-------------|-----B-----------T-----------------?-----E-----------------o-------o----|-XB----E----E-----------|------o-----|-------oM--?X-T--o-------------?--XT------E-|------?-E----M-o
----------B---|-B---B-o----T-------?----T---------------E--------?-----E----------M------?MT-------T--------B--EX-----o---T-----------------|----------B---------|o-M---------------X-----E---------o--?
----T--M-------------------?-------|-----------|X--------------T--X------o---|----E--X-------------B---------o-----E-o----X-|-----M--X?--------------?----------E-----E------------|---------X--------vT
--TXT--BTE---B--?T--|------TT-BEB-------|-X-------T-oM---BX--|--?MT?--MB------EX-EB-------B-X-E-?T--|---X--T|---M--X?----X-?-----Eo-----?--X--?---M?M||XB--|---?------|--?----E-?-B---------XoXXE--B-of|
-----?-TX-?--?---?T--?M-M-|--||E---?o|--------ME----T-------M---?B-?o----X---EM--|--B|M?-MB----M-E-X-T--E|Xo|--|--|--B-------Bo---X-----E--B--B-Eo---?MEEM----B--------E-B-o-Bo|M?-?--B-EXoB-||-----T-fT
--T--------o-----E-|--MB|-E---|?-oo?--M-B|--E-|--T---?TE-----T-----|--------?-TB--E?-T----XB--|--------M|B-|--M--o--?X-MB--o-?-------M----?----------E-T--M-M-|--------o------------|----?----E-------f-
-B-|--o-----T--M-|----E-Eo-BT-XM|XT--o---X-|-X--------ToB-B-X-BB-----o|-M----BX--E?-----ET---o--E?X---o-------M?-----M-X-EE--XEX-M|----TX------X----T-To-B-o-|----M----|T|MX-----M-----BT-X-----------f?
---E-----XMEE--|-------E--E-MTo---o-------B--o-------|-o--T----ET-----XE-E--X--?-X-M-|---?-?--EB-----TE---B--?--BE?-XX-----?--oT-EM|--o----|--X-----------o-?--Eo|?--X---?E|-oX-|--E---?-o-----T-----TfX
-X-oX-----oX-?--oB--?XBE---T-----E--?-M--oX----XT-T|-?---X-------B------M-----B--M|--oE--E--BB?-T---X-T|----M---E---E-?T-o--E---??-------X|E-XB--o-----X--B--BXB-E---B-----oM--X-------MB-----E--|oT--fB
m---B??-|---E-----X-?o----B--E-|XX---T-|--M|---X----XTB-----E|------B-o----ToB-?E-T--o---|T|-E-----T-----oX----oTM---ET-T?-B-----X----T?-X-|T-----To-?M---?--B-E-----B------|-T-------T-?---EX----?----M
XXXXXXXXXXXXXXXXXXXXXXXXXXXXXXXXXXXXXXXXXXXXXXXXXXXXXXXXXXXXXXXXXXXXXXXXXXXXXXXXXXXXXXXXXXXXXXXXXXXXXXXXXXXXXXXXXXXXXXXXXXXXXXXXXXXXXXXXXXXXXXXXXXXXXXXXXXXXXXXXXXXXXXXXXXXXXXXXXXXXXXXXXXXXXXXXXXXXXXXX
