--T----o-----o------------------|------------------E----------T--T--T------------------o-|---------EE--------ET-----------M---o--?|----------|--E----E-------------------?M--------?-----B-------------|
------------T------?----M----E-----X---------------------?---------o------T------E------------B---------E-------------T-X----------------X--X--T--o----------T--T----E--------------------o------------|
--T---o-----M|----------X---------------B---------------------------------M--?----------------------T----T----------T--E---?------------------T---------------?-B-T----------M-------T------------------
---------X-----------E-T---o----------T---------------T-----X-------|---------X-X-o--------B------------E---------o-T----------T-M--T---|-X---------B--T---M--------------T--B----------XT-------T-----T
-M----------X----T|--M---T---|--B--------X--------------------M----o-|--------B-------T------o--------------B-----?--------M--M--------------T----E------------------X------------|-o----------|-------B
-?-----------------------------o----o---------------X-M--|------------------B-T--------B----?--------------M-BE-----T--T---X--X-------T--------------------|----------------B--M-----------------------M
------|----o---E------E--EX-------X--Eo------B-----M------B-o--------M--B-------|----------X------|-----E---------|--M--------------o------B--M--------?-----------------?--------E------------B--------
-----T-----|-------o--------o------------M--X--|-------E-------B-----------B----X--o----------E---E--T--------------------E--E?------TB----------------------B---M---------------|--B-------o---M--|T-vB
-------?M---E--|-oT---B-?---|-------M--o---o--E----B?------E--?--B?-------ToX----BT---E----oM------T-XX--|---E------?E-?o--XE-----|E|--E?|?E-X-?M--X-B----o---|--------T?MM-B-TM-o--E-E-E-----TE-----ofM
-E-|-MB?ET-|-|B---T-oE----B--T------?--X-T--B?--?-------?-----E-E?|o---o------X-oB-B-oT--To----?B?----T--?----E-?-T--------|-o|--o?--T----XM?oX-T--o-X-TMBEX---o--B---o-?----E-B-?--B--MTE?-?---|-B---fT
-B-----o---?-E---B----B|--?-o--X?------X--BM-??|--o-M----B------------M--------EE-XX-X?|--------?M--X---B-----M------XTM|E-B--X--X-M-TXE---------B---M--X-------MEEoBX--To-M--------M-oT--oT--T-?X?TX-f|
-E----T?--B---XX--T-?--B?---M--?---E--oo--M--BM?BTMETM------------X?-TM-E---M-?--?X-M--o-BX----||----o?--E---oX--oX----|-T|--BXMo-?----o--E?-------X-EoM?----M--Eo--X-?--Eo|-X?-X---o----X----B|---?--fo
------|-E--?E-Xo---?----o---TB-??----B-----|---M----BMo-M-------|---TM|---o--MX?-To---BE--MEE---------|-B-X-----------MMT-----M-B-BTB?T--M-Xo---X|-?---To---?M---oo|--oXB--B-?-------E--Eo?--B?|B-B|E-fE
-T----?ETX-o|-B--?--T|B-------MX--?-----M--E------B--|--?---?-M---E----M-----E---XE-?--------T-B||-----M-E?--M-----oM-----BM-EE--|--XX-E-|-?TB----TE--E---?M-o---?----E---|---MT--?T---oM------T-o----fo
m-E--o--o----MMo-?--X-TE----E?-BX---?B-?--o-|----|-----------B-|-T-oo-X--?-TMB-To-X--|-----ooX-B--X-----ET-|----?-?----X--X?EX-M-B--B-----BEX--|--|---X--M--X-------?-EoMX----|-----Eo-------?--E----?T?
XXXXXXXXXXXXXXXXXXXXXXXXXXXXXXXXXXXXXXXXXXXXXXXXXXXXXXXXXXXXXXXXXXXXXXXXXXXXXXXXXXXXXXXXXXXXXXXXXXXXXXXXXXXXXXXXXXXXXXXXXXXXXXXXXXXXXXXXXXXXXXXXXXXXXXXXXXXXXXXXXXXXXXXXXXXXXXXXXXXXXXXXXXXXXXXXXXXXXXXX
