--------------------------------------------------------------------------------------------------------------------------------------------------------------------------------------------------------
--------------------------------------------------------------------------------------------------------------------------------------------------------------------------------------------------------
---------------------------------------------------------------------------------------------o----------------BBBBBBBB----------------------------------------------------------------------------------
------------------------------------------------------------T--------------------------------X---------------T---------------BBBBBB---------------------------------------------------------------------
------------------------------------------------------------|------------------------------------------------|----------------------T-------------------------------------------------------------------
------------------------------------------------------------|---------------------M--------------------X-----|----------------------|-------------------------------------------------------------------
------------------------------------------------------------|------------------------------------------XX----|----------------------|-------------------------------------------------------------------
------------------------------------------------------------|----------------------------o-------------XXX---|----------------------|------------------------------------------------------------------v
------------------------------------------------------------|------------------------------------------XXXX--|----------------------|------------------------------------------------------B---T-------f
----------------X-------------------------------------------|------------------------------------------XXXXX-|---X------------------|----------------------------------------------------------|-------f
---------------XX-------------------------------------------|------------------------------------------XTXXXX|--XX------------------|----------------------------------------------------------|-------f
--------------XXX-------------------------------------------|------------------------------------------X|XXXX|-XXX------------------|----------------------------------------------------------|-------f
-------------XXXX----o--------------------------------------|------------------------------------T-----X|XXXX|XXXX------------------|-----------------------------------------------------X----|-------f
------------XXXXX---------------------------------------X---|------------------------------------|-----X|XXXX|XXXX------------------|X------------------------------------------------X--XX----|-------f
m----------XXXXXX--------------------XEXXXXXX----------XX---|------------------------------------|-----X|XXXX|XXXX------------------|-------------------------------------------------XXXXX----|-M----EX
X------XXXXXXXXXXXXXXXXXXXXXXXXXXX--XXXXXXXXXXXXXXXXXXXXX?XX|XXXXXXXXXXXXXXXXXXXX--------XXXXXXXX|XXXX-X|XXXX|XXXXXXXXX---XXXX------|XXXXXXXXX-XXXXXXXXXXXXXXXXXXXXXXXXXXXXXXXXXXXXXXXXXXXXXXXX|XXXXXXXX
