-EB---B--?-------------M-----B---M-----------------------------M--------B-----E----------E------------------------------------?E--------M-----------------------B---------X---M-------------------------
-----B----X-------------------B---?X----E--?-------X---------------X---------------------------------------M-?-B------------E---------?--X---o-B--------------o-X--------B----------------B--B------M---
-M-----------M-----?-o------------------E--X-o-------------E---------B-------------------M------?---M-------o-E------?-B-B---------------B----------M--------o--------B----B----------M----o-------M----
---B-E-X-?------E--------------B-------------------oX----E---Bo--------------------------o---E-X-----M-------X-----?-------B-?---------?----------M-----B--?---M--------?------E---E--------E-----------
------------M--?-------E------------?---------?----X-------M---------Mo--M----B-----E----B--------X----B-------------oM--------------B--B----?----------------o-E-Eo-------?-B-------E?--------------o--
----------------------E------?E-----E-EEX-oX--E--------------?---------o------o-----M-----------E---o-X--------o-----E----X----X--------M-------B--------E--------E---E-?---E------E-B-E-?---oEB--------
--------E----?----B---?-----------------------------X---------E---------M------B-------------E----o------------X----Eo-B----------------?--------M-----------o--------MX-----M---oX--E-oM------E--Bo----
-M-------B---M------------------?-X-------------E-B-?-X----B-------B-E--M-------X----M----------ME-B-------------B?----o--E----------------E-------------------?------------E--------------M----------v-
-B-o---E----?--o-?--MM--Eo-o-oM-E-o-?--?o----E-B-?-o--BE-----------o?o-E-----------------B-MM----B-----E----o---oB------------E--Bo--M---M----XM----o--?-?-B-X?-----o-oo--------B---------E?-----B-?--f-
---M-M-----X-o-M--------------E-----B--o----Booo-B-B---------E-----E------M-B-XX----------------------------?--E-M-E-E---------?M-X-?--o---?-o-M-----XXM--M-??----------?--------M-M--Xo-o----E-BooB--f-
--E-E--M--X--ME-X-E--B-?----E?--------B?---?--M--EM--M---??-M-X----?--?-----X-o-----EE-----o--M---?o-o---X----Eo--B-M-----BX------EE-E?----------------EBo-Mo-??---B--E--B--B----MM?E-----E---X-----MXf-
--?---BBoE----o---X-----X?---X?-----?------X---o-?-B--X------o-oM-BM-o-B-----B?----o----o----B-BoX------EB--X-X--M--X-------M--o--?--?---E?-M---------BMo-EX--M---X--E--B-ME?-----X------oX----?--BM--f-
-oM--E-BB-------o-X----?E----E?B----B--XEB-Bo----?oM---o------?----o-M-oE-X-B---o-E---B----M----X??-o-M---?X------M--BB-B---X-E?EMo-E--X--X---?MME----Xo-------M------X----oX-?-?M--EoE----E-----E--B-f-
-X?---T---T-E-?-?-?TT-T----o-TTT------T-ToTTTXM--T--TX-E-T-T?------?o--To---EX-TT-TTM-XoTT-TTT-E-TBT-TEET-ToTT--T-T-MX----TT-T-TT-T-T--?XTTTT--T-TT-T---MTT--ETXX-B-TT-B-T--XTTB?TB--o-TTT-TBX-T--T-T-f-
m-M-??|---|-----ET?||-|------|||E-XX--|-|-|||--oB|-M|----|-|?B-----B--o|-?---E-||-||----||X|||---|T|-|M||-|o||MT|-|B-B--o?||-|B||o|||-o--||||--|M||-|--XE||?--|T--?o||-M||E--||-||---XE|||E|-E||BX|-|-f-
XXXTXXXXXXXXXXXXXXXXXXXXXXXXXXXXXXXXXXXXXXXXXXXXXXXXXXXXXXXXXXXXXXXXXXXXXXXXXXXXXXXXXXXXXXXXXXXXXXXXXXXXXXXXXXXXXXXXXXXXXXXXXXXXXXXXXXXXXXXXXXXXXXXXXXXXXXXXXXXXXXXXXXXXXXXXXXXXXXXXXXXXXXXXXXXXXXXXXXXX
