-----------E---o---------MX----X-E--------T----E---------------------B---o--T--------T--M-TX-------------?----------|----------T--X--Mo------------------M|----T-B----------E-M-MM-------------B-----T-B
-M--Bo---XX-----------E---?|----------------------o----------------------E-------M------X--B---M--------------|o------o--------------|--------B---X---------------------------T-----T----------|-------|
----X--Bo--------------M---X----T--XT-E-------E--------To-|----------------X------------------|-------------------|----------MM---------------M-------o--Mo---?---------BM--T----X-----------|---------o
---M-M-----T-|------------M--|-------------------------------------E----o-?------------B-B-----|------------------------T------B-?-----------E|-------|-------?B--------------EM----X--o-X--?----------T
-----o|----B----|-?|---------------------X---------B----?-----?--M-------E-------X-|?X--T---------------|--------------------T-----------T-|--|E--------------------B----------T---------------oT-B-?--X
---------T-B---B--B------?---|----------o----X---------M-----|------------------------------------------E----------------|----E---B---E-----------|-----o---------------E-T-o?-------M-M?---oT---------M
----T--------|--?-------?----------?E--?---------M----------------T----------?-----------?-----B-X-----------------X-------------------M---------?----M---------X--------|-----------T|-M-------B------|
------XB---------B-------B-B----||--------M---M-------------X-B---------o--------------|--------E---------M-------|-T----M---M-------------------|---B----------T--T|----E------B-------|------X--E---vE
-------------X-TB-----EB-?----T-Xo--E-?------M-|BEMM?o-----|?o-T|E-------B-----o--Bo--?--?M?-M-----|--X--T-TM----B--o------TX--------o-X?-M----------|--M-BEB-E------XX-M-E--------?-?XEM--E-|M-BXBTX-f-
----|-----------|M--M--X---B--|----|-----BM-B--B--o--------o----MTE-B-M-------B---|-?|-XTE|---M----E-TX---E---B-|-------o-M----TT---MM-oBE-EX|---E------T---oB--o-E-oM----|---?----TE|MEM--B-Bo-B-T---f|
-|--BX---o-o-----?-B-----E--?------E---?--|X|-TBoM---|----T---?--T-?MB-----?---M-M--M--X-----X?---||T----TM?|-o---oMX---M-E---o-To-E-----|-Xo-XE-E||-T---X---M-X----|-----|---E----E----|------|--E---fX
-X--|--B-?--?X?-?--o---MB-------E--To-------B-BXM----B?-Bo--T-X--M-----MX-M?---?-----o-M|---?--XET-----B------|TXBM--|-?----o--XX--|---o-B-o-|---X-?----------?M-----------|-E-M-XB----?--B|--T-------fB
--E-o-?-o||--M||?-M---|-X---T-M|ME----?------M?M--B---|T-----MM---T-TM--X?-?-------------o----MMX-?----oo|?---T-ToXX-o-------oTT--B-----MXoB-XT-T-oM-M---T--------T--o--|--XB|--B--X--BE-E-oET-B--BT--fE
---X-T-B-M--------?-----B--oMBE--M-B-T?B---X---T-o--------?--X----BX--oM--o---?B----|--T---|-|--X-X-----M-o---B----E-Eo---B--M--ME-o-oE--?-oEE---M---E----B--T-X----EM-B----X----M--o----MM-----?M---XfT
mTEEM|o-----EoM---X-o-T----BoM--Eo-B-E----XoM-M--TTo-?-o-TMT----EM-T---B--E-o--??---E----|--?---X---B-?XM----o--M----?---TM--X--Bo----X-T?T-----?Eoo-M-o?-T-X---E--||?-E---oo-B---o--M--------E-M----T-?
XXXXXXXXXXXXXXXXXXXXXXXXXXXXXXXXXXXXXXXXXXXXXXXXXXXXXXXXXXXXXXXXXXXXXXXXXXXXXXXXXXXXXXXXXXXXXXXXXXXXXXXXXXXXXXXXXXXXXXXXXXXXXXXXXXXXXXXXXXXXXXXXXXXXXXXXXXXXXXXXXXXXXXXXXXXXXXXXXXXXXXXXXXXXXXXXXXXXXXXX
