-?-----E--E------------?----M--------B----------------B-X--------M--------------------------M--------------------?---------??------------EE---o----M---------------------M---------------------B--------
-------------------------------------------B----------E-----o-------o------E-?E-o--BE---?-----------B-----MB-M-----E--------X---o---M-X---M---o----------------------------------------------?----------
-----?E--B-------o-----X-E-----?-----M-------M--X----XoX--------?--o---o-------B-------B----------------XBoM---------B-----B-?---------M--X-X------o-----------M-o----------o----M-M--------------------
--------B-XB----Mo-----?--?----X------?--------M-X---------M---M-----E--------------M------o----o--------------------------------?------------o-----------?-X----------B?-----B-----E?--oX----------?---
-------B------o---------E------------?--------?------------------------X------------------M--o---------MB-------------?-----------E----E-------?----M--------o----?--------M--?--------------X----B-----
-E----o-?-M----------o--M--------?--------Mo--------------------E----E--------?-------------E---------?----XB---------------?-------------------?---------------X---o?-----------E-M----oE-?------X-----
--M-------B---------------B--o--------M-----o----------B--------------B---M------M-----------?--E-------X-B----------?----ME-------------------M----oB-------?-?----E---------M--------------B-?--------
--------MM?X--M------M?-M--Mo----------E---B-------------------o-E--------------X--B----------------------------E-----------------M-M----------EB--M------------M-M-------o-----oB--------------EBM--ov-
----B-----M-----X---o?--E---?---?--M------E--E---MB-----B--X-----E-E-----M------E--------?------ooo--M-Mo--o--E?-X-?-----Eo---X--Xo------M--?o---M-----X--EE---M----MXBoE?-?-M-E------------B---------f-
---o---B-----??B?------?EXX----XM-M-E----X-M--E---?---?---EBE-Xo-------EEX-?-?X----X----------?-----------?-??MX-----o----B-------?--o---------B------M-E-------M-XE---E-----E??M--o-BBo-E------o-----f-
---B-M?--MoEBo------M----E----?--M----o---E----B----------o---EE?--?MB--M?--B-XBo?X---M--EX?---M--E---o--------o---BE------X--B----------o----??---------?---?-MX---E-M-B--XE---Bo?----X--o----M------f-
---?---B--?----??M-B---B--o--------B----oM-o------M-E-M-BXME--M-E----oo--XB-------M---EX--?------B---EE--B?-----X-?-M-X-M-M--o---E--E---X------E--E---------E------?-E----ME-B-o-----E-----XM?--?M----f-
-E-B------?-XE--M-------MBX----?--------?X------E-B--o-oMX--X----B--B-?--B-E----o---o-E------------XXE-----B---B----o-X?----------B?---B----X--?X--?------------o--MM?-o--B-E-B-B---------------B?-oM?f-
-------T---T--oT--T-TT-ET-T---TM---TBTM---BT---T----M-T-------T-T--B---E--TB-----T--TE-T--TT-TTT------B-T-T-----B----X----T-----?-TT-----T-X-T-TTTT----TT---TTTM----X------T-TT-TTT-X----TTE--TETT---Tf-
m------|E-B|--T|--|-||-||-|---|M-?-|?|-o-B-|--|||T---||--T--TE|-|T---|--M-|?M-E-||-||M-|E?||-|||||-M-oT-|-|-------E-M|-X|-|--M|MT-||-BE-o|o?T|-||||MM--||-M-|||-T-----||---|-||-|||M--M--|||--|E||Xo||f-
XXXXXXXXXXXXXXXXXXXXXXXXXXXXXXXXXXXXXXXXXXXXXXXXXXXXXXXXXXXXXXXXXXXXXXXXXXXXXXXXXXXXXXXXXXXXXXXXXXXXXXXXXXXXXXXXXXXXXXXXXXXXXXXXXXXXXXXXXXXXXXXXXXXXXXXXXXXXXXXXXXXXXXXXXXXXXXXXXXXXXXXXXXXXXXXXXXXXXXXX
