-----?--M----------?M-----|-M------o-----TX---------------T-----X----------M------E--------|-----------------------|-X-----?-|M------B-----|----------------o-X-------------?-----------------------T--B
--M-------T-X---E--------------E-------B------ET-----o----E--------------M-------|---T-T---B----M----?---X-M-|--------o---X-------M-----------|---|--|-------|X------T-X---X----------|--?---T---E-----|
-T--BB--o--o---------------------------M--T------T----------T--o----------|---|----E?------M---X-------------X--T----------------M--------M-----?-E----o------M--------M----?----X----T--B------T------|
----E-------------T--X---?--?-|-B---------MoB------------------oXX-X------M----?E|---E----EM-------o------------M------?--M---BB---|B--------o---E-TM---M----X--B---------------B---?M-----E---|--------
-------E----------?-----------------M-Bo---?-------------|--o-E------|-------BB--------T-----|-|--------------?---------T--------M---------E---|----------------E---------XX-------?-------?------T----|
--------M---|------------|-----------------------BT-M-------------E-------M---------------|---E-----|?------------X--o----M---E--BE---X-----M---------o----o-------E---E------------o---------E-----E---
----------------X------------------M--?------E---T-------o-X-------------------------------?--BE-----------|-----------------M---------XM---------------------B----------------E-?----------X-B|-------X
--||----T----B--?M--X-------------?----X-----o-?--?---|-X--------TE-------|------|--X------|------BB------X-------T--------|----------E---|---M--------E-------------------------------|--------------vE
----T----|-|----MT---?-|---------MMM?--B---B---MB-------o----B?--MB--B-----MB-T--?--oXM---To-TE----oX|-|X---?-----o-X--X----BE-T?-B----E-|-----B|----?--T--B--B---MX-E-X-E-T----o--Xo-M--M-----T|--B--f-
-o?--ET--M-?E--B------BBX-ME--M----MT-T-T-X--T-------?-T-M-?--M--o--M----o-----X-T-----MX|-TX----------?-E----?MT-----ToB-?---E-|T|-T-----?|T---X--M||-X-X-Bo--o--T-MXE|--TEE--M-|B--T|?----E|?-------f|
-?M----B-?X-o-?-M-?---o-E-M---E-----|-EM------MM-?oXXEM--M--T|-oBBM-T-M----MB---X-B-ooEET---B-?-------XE--B|---M-E--M-B----------|--T-X--??-XB--B--|M-|-----B-|---?||-E---T------XM|T|?-X---T---X?---EfT
-o--?-T-B-|--B-?---T---XTo--------o-----?M--To--|E?TE--?-X---T?MEX--?-XMMMo?|B-B-T---X---o------E-M-------?-E-E--o-MX?----------|-----?-TM--?----BB---X---|-oTTo--X-?-E-X--B-Eo-|---o--T-X-B-X---M-|--fB
-T--?X---?---X---EE---?-B---T-|M--M--E-o---oE--------XXE--E-|-E-T-E--?--o---oB--|??|----o--|-------E-?-X--B--o-X---M--B-----XoX-----------|--|----Xo-T----o-----T---X-?--M------BE---?To|-??---MT?EX?-fB
-||----M----X-|B-M-M-X-X-|-EBB--M-oo-B---------M-o-E-?---MX--M-||M-----|--T--M--EXB|T---?----E--?-?--?-------------BTB--TXT--o----B-E----------?T-X-|-|---X---------|?-X--|---T---o--?---Xo---XB----|-fE
m-oo--?---X-|-----|--o-o-T-E-----X-Xo-EB------BT--o-X---Mo--|--X-o---oB-?----o---|---M-T---X--o?--M-M-?----T----oM--X------X----ET-?--?---B|--o|-E---------E------XoMX----XoT?----?-|--B---M-----?---E--
XXXXXXXXXXXXXXXXXXXXXXXXXXXXXXXXXXXXXXXXXXXXXXXXXXXXXXXXXXXXXXXXXXXXXXXXXXXXXXXXXXXXXXXXXXXXXXXXXXXXXXXXXXXXXXXXXXXXXXXXXXXXXXXXXXXXXXXXXXXXXXXXXXXXXXXXXXXXXXXXXXXXXXXXXXXXXXXXXXXXXXXXXXXXXXXXXXXXXXXX
