---------E--|?--B--------o----------?--M------|----------|---------------------o-----------------T----E------|----------E--------------o-o--------------T------------Eo-----X----M--?------------------B
---------B--B--E-------------------|----------------------------o--------------------------|------------X-------------------------E--|----E-M--X-------|------------M-o---------------E-?M------T--M---E
-----M-------X-----o------T----|--------E------------M---ME--oX-|?----E-----XT--B---oX---E----E-M--------------E-------------------?--------------E-|-----o?-------------B------------?---M------------?
-----T--M-X------MM------------------|o-T-|----------X--E----------------------|------o--B-----B--B---B|----B--o--oTTM---E--------------|M----------o---------------?--------------------Xo-BM--T-Eo---?
---|--T-----------T-----------T-------X------------XXo----X-------------E---------o-------|---|-----T----------TBE-------------o-----------o-------o-|-o-|-----o--------M-|-----B----------o-------M---B
----||?------------------------------------B--------------M----M--M--E---?----------|---------B---?--------E-------------------------|-TM-|------M----------------|X----------|------------------------o
---M---------------------|--o------------E-------|-X------------?------E--------B------------X-|----------T----o------o-----M--------T-----E----------?---?-B-----B-----------E---------M---------o----B
--?-------------------------|---TX---|----o-o--------X-------------------X-----E---MM--------o--------X-----------B---------B----------------------X-------------B--T-------------E--------M-B--M-----v|
----MBo-E---T------o?------Xo-----T--E-TE---|--X----X--E----B-------TXM-?---BEX---Mo-MM--o-M-XB--B|---X-T-ME------M|XX--------o----E-E-?-E--o-o----?E-oT----oB-|-E-ToT--|------EX----o-B-M-o--o--?--T-f?
-----?------BB-?-BX-|---?oT---||T-TT----?X-XX-----|---M----|--------?-|-T-oET----M-M|B----E--T-|T--|M------T----XE-----B--|-|-T-?Xo--||M?--MX--TX-EoT----MToM--o--------XEBM-X--------|-------TT--T---fX
-|--?---|----o--?E--X--|-M-M--oT|B---B-|-M|--|XX-----?-B----M-TTM-XoX?|---B|B|-|---?-X--B--ToBM--o?|---X-----|X-MT-E?-----B-MXB-X---------BT-----o-oo?-X--MM---o-M-T--T-----BT?--T-B|X------B-o--T--M-fX
------XX--Eo-----------M-B---------oT|-------EE-E-B-----M----oBT----||--X-E-----MB--M|----E---MM---------T----E----|o--X-----E--T--X------T-o-T--M--Mo---X|--EM--o-?|X--B--BT-XM-----?--T--?--T--T----f-
-B-|--|M---------|-T-XM-----o--T---X--M----o-B---|B???--TE??--X?-----X----T--B--T---||B--E--T-XX?-----?-----B---MT||-|T-?-Mo-E-oMoB---o-TX--o---E-------------?----Eo-MB--T---?--?--T-B-|----o|-|B??|-f|
-?-|-?B-o-X---o--B-XMM-?-----E-?--o|-B--------o---T-||-X-M|---E|--?o-E---B-X-?--o-------B---|E----B---oB?B--X|o------X-----T-X---TE?-T----|------------?---TMMBo----|-|--TB--T-X---?-?M----T-T-|B---T-fo
m|--M--|-M--X-MMM-?B---E-XTT-E--------|-T----oM------T?-B---TM------B--B----E-ooo-?-?T-o------ME-|-B--oB|-B----ToM-M--oT----M--EoMM-------X-T-----ooB---B-T----?--E-?B----M--oB---|-T--E?--T-----|-----o
XXXXXXXXXXXXXXXXXXXXXXXXXXXXXXXXXXXXXXXXXXXXXXXXXXXXXXXXXXXXXXXXXXXXXXXXXXXXXXXXXXXXXXXXXXXXXXXXXXXXXXXXXXXXXXXXXXXXXXXXXXXXXXXXXXXXXXXXXXXXXXXXXXXXXXXXXXXXXXXXXXXXXXXXXXXXXXXXXXXXXXXXXXXXXXXXXXXXXXXX
