------------------E----B--|-|T|M----------------------X------|----------|---------------M-------E-----T--------------X------TXX----------M-------------------------------?---B-------?-----------------E
------T--E--------------------------?-----?-B----------o-T--o---X-----TE------X----|-|----------E-X-------?----X--X-----------E----M-----X-----------------------------------TT----T--|--|M-------|--E-?
-----------M-?---ME-----X---?----X---M----------------?-----------------------------------------------o--?--------------BX--------B----------X----E------B---B-------------------------E?-------E-E----B
-----B----M-X-------T------------------o-------------T-M---|-----------------?------------X-----B----------o-M---o--------------M--X------------------oT--T------o---E--T----------------------|---?---M
--?------------B--?------------?----M-o-X----------------E--T-?T-----------X----?|T----E---------------------?-B---------B----X--X-E------------o-M-------M-T--------BX--M--------------E----------E----
---------------|-?-------------?---------------T----------------------T---?--------T--------X----?-X----X----E------------------M-------------|-----------T-------------M-----M------|--------T--------|
-----TX-------------X-----?-----EB-----|----X---X-o------|----o-----M--?------M-M------------|-M-----TT------------E-----M------------------|-------------EE----o------|--BX---E-----E----ET--E---o----?
-------------------M-T---------B---------XEB-------B--------------?-X--?o-----------X---------B-E--------B------------------------M----X-------------------B---------------o-T-------T---X---?T|B-----vX
-T-o--B-M-T----XE--|M--E--M-------X----oE--oM-|o--o-BT----T-oB----B--|--?------T-E--B-TM-o-TB-BoM-Mo--B|-X-?-M-?-X-|--?-X-?M------E-X-----B---M--|-T-ME-X?TT-----o--E---|-XE-EX----BET|-M-M-----oM---Ef|
-----E----E|---B--oTX----X-||---BM-?--E--Eo---?M----?TMo----||TM---??---Mo---E?E----X?B---TX----M-X-------?--oB--BTE---o--E-X--|-----E--|-E--?-M-----B---B----T?o---?oB--TB----E--|?-X-|-T-----X-M?B--fE
--BB----E-----o--o-o---T-E--------|---X--??-------X-XM|T?XT-T--X---X------|-----X----TTX-o?T--T---?B|-?-XXE??|--M---?-o--------B--TX-E-------|-----XT-XoE----|------M----?--|ET------BT-E--T----ET-?--fE
---X-?--EM---?----------Bo-?-Boo----X----EE-X----|--Xo-o---|----------X-|-E-------B-X-B---E-T----E--T---EXo--?-----?-----T-----EoX-ME-?------------|-----?-X--?-oX-B----B-|X----ET-o-----o--E--M-?----fX
--B-T---T--M-T-B--M-EE?-M-oM||--?T-|------E--BMT--oXX-----B----?|XXEB?o--|-X-?M--o-----XE-B-T-E-B-----------?M-T--XT-?-?-M-M-B-B-M------ET----B?|X--XT------B--------o-BM-o--o----B------E-M|-BBT--To-fM
--XME--M--------ME----T------?o|-----|-T-|---?-oo-----X-T--|--MX--B-----|-MT----T---TM-B----------M|--Bo---o---M-----ME----?--Mo-------M-T--?-|B-----o-MoXXo---?--?X-----B-------M-M------M?--B-|---M|f-
m-?--oB--------?---X--M-----|--EMMXT--------EMoE?-X--B-B-T----|-|?X-----B--BT--T-M|------------o-?-X|-?MM--BXM--E-|T-----M---M-----o---T----T-o----BMM----o---M|M----B-----|o--XE--------X---M-T--X-M---
XXXXXXXXXXXXXXXXXXXXXXXXXXXXXXXXXXXXXXXXXXXXXXXXXXXXXXXXXXXXXXXXXXXXXXXXXXXXXXXXXXXXXXXXXXXXXXXXXXXXXXXXXXXXXXXXXXXXXXXXXXXXXXXXXXXXXXXXXXXXXXXXXXXXXXXXXXXXXXXXXXXXXXXXXXXXXXXXXXXXXXXXXXXXXXXXXXXXXXXX
