-----------------------------------B-------E--------------------------------------------?------------------?--------o-?-------------------------------------------M----------------------o--------------
-------------------------------?-E-----E------------------------------------------------------------------------------------------------o----------------?----------------------B---------o-o-E---------
-----------M---------M------------------------------o---?---------E-?----------------B------?-------o------------------------B-------------------M-----------------E-------B----------------------------
-----------------------------------------------B-----------------------B-----------------------------------------?------?----------------?--o----M-------------M--M----E---------------------------?----
-------------E-------------------------?------------------------------?--E-----------------------------o-------------------------------------o-----------?------------------?---------------------------
--------o-----------------B-------B-------B------------------------?---------------------------------------------B?--------------------?---------M---------------------------E--------------------------
-B------------M------------------------------------------E--------M-----------------o----------------------M---M-------------------------?------------------------------------------M?----------------B-
----------------------------------E-------MB----------------------------------------------------------------------------------?-------------o-E------------------------------B-------------------------v
-------B--o-B-----------------------------------o----?---------------B-E-------------------------------------------------------------------------------------------M-----------------------------------f
-------------------------------------------------------oo--B---o-------------------------------------?----B--B-M-----------------------------------------------------------------------B---------------f
----------------------?-----------------------M-----------------------------M------------M----------------------------E-------------------------------------M--------------B--------?-----------?------f
-B---------------------o-------B--------------T------------------------------------o----------------------------------------B---------------T------------------------T-----E?-B-----?------------------f
---------------------------------o--------------------?--------?------------------------------------M-M-?----------E----------B-------------|--------?--o-------B----|---M--M-o------?-------T---------f
-----T----------T---T--T-T-T----T--T--T-----T---?T-T-T?--T-----T----T----T-T-T-T----T-----T-T-o----To---------T----T-------------------T-T--|-T--T--T---T-------M----|---T-T--T----------T?----T-T---T-f
m----|-o-?--E---|---|--|-|-|----|--|--|-----|----|-|-|M-E|-----|----|--Eo|-|-|-|----|-----|-|------|?------?--|----|-------------------|-|--|-|--|--|---|------------|---|-|--|----------|-----|-|---|-X
XXXXXXXXXXXXXXXXXXXXXXXXXXXXXXXXXXXXXXXXXXXXXXXXXXXXXXXXXXXXXXXXXXXXXXXXXXXXXXXXXXXXXXXXXXXXXXXXXXXXXXXXXXXXXXXXXXXXXXXXXXXXXXXXXXXXXXXXXXXXXXXXXXXXXXXXXXXXXXXXXXXXXXXXXXXXXXXXXXXXXXXXXXXXXXXXXXXXXXXX
