------E|------------?--X--?--------------------EXT-MX------M-------------E------------------M----------T-----------------------T---------------|---E------?----?------?-B-----?-----T----------B-o------
-------------T-----|-B---o------o----------o----T------X----------M-------|B-----E-----------Xo--------M-B-------M--T-M-----?---B-----------------------------------------T-o-----M-------------T-------
-----X----------X-M------X--------------o-------E--|----------------M-----M------------------M-----?----M-E---------T-----T----Xo-T--T-B----oo-?----------------------------|---X-----EE----------------
----------------------------E-X------oM----------------------E?----------X--------------E-B-X---T-----------o-----|-------E---?--M-o--|------X|----------------T-|------------------o-----T--Xo--------M
-?------o-----B----|--M-----?-----M-o-T-----------------M-----B-----------------X---|---?---E--------B----------B-------T--------E------------T------E---ET--------o-M-?---------------------|---------T
----MM------------------------|-----?-----------------------o-X--E--------T-E|---------X-----|--------E--T--T---------X---------o----?ET-----o----------B------------T------o--------o-?-?---T?--------o
--------------------------E-T---B-M--o?T---------------M-------------------------B--------B--|-------------o------------------------------------B------M-----oE-|----------E----------|-o---------------
---------------------------------B----T---o---------------B-----|-------------?------E-B------E-----MB--------------------M--E---------------------------?--E--|-B---------------|-----T----X---------vo
-E----M--X---??---?-----BT-M??--?XMETE-----T?-----B-o---------T------?B---B--M|EE------X------BE-------?X|-X---------------o---M|-o|o------|--o----?-M-To?E--------ooT-----E-T-?Mo-?----------B--M-E--fE
-o-B--T----|-||----M-E--------EE--TMo-E----E--MM---?E----X-oB-|-B-------B-T-X-?B------M-B??-T--B---EE|X---B----T--|X--o-E-BXB|--B----M|--|-|E--EE-Mo-?M---E?|X-|--|--X--?-oXTM----T---B---?-------?---fB
--B------|--T-?-M------E?----M-oM-?B---o-----?-X-?X-TX--T|-----|o---EoB-?----o-|-?-T-?----X-TET---oo----E?------?T-----------|--?----------E-T?B-|E--BMB-EX-o|-E--X-XE-ET--E--?-T-E--B-----E------?-M-f-
-X-E---|-|-E-B---?-?---B--X---T--BX---M--X-o-XE------------E--E-Eo-X---T?|------B|--E--o|-B---BT-----X-|--------X-T--X----BM----M-M-M------|-XE---o--B-B----oE--o-B--TXo---T------------TT-------ET-M-fo
-BE-T?-----B-----BM--?-----E--M--X----T----E--o-------M--X--------Bo--EX---T--|---X-|T-|-B---EE---BB-T-B--------oE-T--|-B-T--B--MT?T---B--B-?--E----E---------E?-M------E-X--B?Bo--oX?---Eo--o-MT-----fT
---T-X--XB-E-----T--|--T-X-E--E---Mo-o---M----E|-B-oo-|---?X----TE-B---E---E--B-T--XBX-?E---X--E|--?----B-----TE?-T---M-B----|---X|----E--E?---|?-----BB---B--M-M---M|--?o--MTTT-T?X|--?T?---Bo-E-E|-Bf?
m--B-E-B------BE---|-E--------Mo-X-T-E-E-----M-|-EMoT-E-B|E---?-M---T---?--?--?-M--o-o--MB---XM-?T?---E--o-|B--?-----MT?-E|-M--X?B-?--oMo-X---?|-B-TT-T-o-o?--T-E--?B--ET|-E-M---E--oEE--EXM-M|--Eo?---X
XXXXXXXXXXXXXXXXXXXXXXXXXXXXXXXXXXXXXXXXXXXXXXXXXXXXXXXXXXXXXXXXXXXXXXXXXXXXXXXXXXXXXXXXXXXXXXXXXXXXXXXXXXXXXXXXXXXXXXXXXXXXXXXXXXXXXXXXXXXXXXXXXXXXXXXXXXXXXXXXXXXXXXXXXXXXXXXXXXXXXXXXXXXXXXXXXXXXXXXX
