-----------o---------------------------B----------------------?--------------E-M-------------M---M-------------?B---M--------------?-o-----------EE------------------------?---------?------------------
-------------------------------------------B-------------------------------------------------------------------B--------------------?M----------------------------------------------------B-------------
-----------------------E--------------M--?--------M------------------B-?---------------------------------------------E-----------------------------------------------E-B--------------------------------
---------------M--------------o-----------------------------------------------------------------------------M--------------------------------------------------------------M--B---------------?---------
-?-----------------E------?----------o-------------------------------M-------------------------E-------------------o-------------o-?---o-----------------?----------------------------------------------
-----?------o-------------------------------------------------M------?--------------------------M-------------------------------------B-----------------------------------B------o---E------------------
----------------------------E-------------------B------------E--B------------?------------?-----------?-----------------------------------------------?------------E?---------------E----------------?--
--B---------B-----------------------------------?----------------------------------------E---------------------------E--------------------?-----------------M------------------------------------------v
------------M-------?--------M------o---------E------------------------------------------------------------------MoM---------------------------------------E------------------?----o-------------------f
----------------------B--------B--E------------------------------------------------------------------------------?--E--------------------------------E----------------------------------M--------------f
------------------------------------------------------o-----B------------------?--o------------------------------------------?---B--M------------------------------------------------------------------f
--------------------------------M-----------------------------------T---------B------------------------B---o-------------------------------------------------T-----------------------------------------f
---------------------------------M-----------------------------------------T---B--------------------------E------------------------------------T-------------|------------o----------------------------f
-------E--------T--------T?-----------T------------B--------------------T-T--T--------T-------T--------------E-----------T----------M----------|--T----------|--B---------------------oT---M-?---------f
m-----o-------E-|--------|-M----------|------------------------M--------|-|--|--------|-------|------------------E-------|---------------------|--|----------|-------------?-----------|-------B-------X
XXXXXXXXXXXXXXXXXXXXXXXXXXXXXXXXXXXXXXXXXXXXXXXXXXXXXXXXXXXXXXXXXXXXXXXXXXXXXXXXXXXXXXXXXXXXXXXXXXXXXXXXXXXXXXXXXXXXXXXXXXXXXXXXXXXXXXXXXXXXXXXXXXXXXXXXXXXXXXXXXXXXXXXXXXXXXXXXXXXXXXXXXXXXXXXXXXXXXXXX
