------------------------------------------------------------------------------------------------------o-------------------------------------------------------------------------------------------------
--------------------------------------------------------------------------------------------------------------------------------------------------------------------------------------------------------
--------------------------------------------------------------------------------------------------------------------------------------------------------------------------------------------------------
--------------------------------------------------------------------------------------------------------------------------------------------------------------------------------------------------------
---------------------------------------------------------------------------------------T----------------------------------------------------------------------------------------------------------------
---------------------------------------------------------------------------------------|----------------------------------------------------------------------------------------------------M-----------
---------------------------------------------------------------------------------------|-------------------------------------------------XXXXXXX--------------------------------------------------------
---------------------------------------------------------------------------------------|-----------------------B---------------------------------------------------------------------------------------v
--------------------------------------------------------------T------------------------|---------------------------------------------------------------------------------------------------------------f
--------------------------------------------------------------|------------------------|---------------------------------------------------------------------------------------------------------------f
--------------------------------------------------------------|------------------------|-------------------------------X-------------------------------------------?-----------------------------XXXXX-f
--------------------------------------------------------------|------------------------|------------------------------XX-------------------------------------------------------------------------------f
--------------------------------------------------o-----------|------------------------|-----------------------------XXX---------------------------------------------------------------------------o---f
--------------------------------------------------------------|------------------------|----------------------------XXXX-------------------------------------------------------------------------------f
m-------------------------------E-----------------------------|-------------E----------|--------E---------------E--XXXXX--------------------------------------E-----------------------------E----------X
XXXXXXXXXXXXXXXXXXXXXXXXXXXXXXXXXXXXXXXXXXXXXXXXXXXXXXXXXXXXXX|XXXXXXXXXXXXXXXXXXXXXXXX|XXXXXXXXXXXXXX-XXXXXXXXXXXXXXXXXXXXXXXXXXXXXXXXXXXXXXXXXXXXXXXXXXXXXXXXXXXXXXXXXXXXXXXX--------XXXXXXXXXXXXXXXXX
