-------------?------------?-?--?-------X-------E---------M-----------------M----M---------XE---------X----------oM------X-------------------------M-------------------B--M-|-------------M---|---------X
--------------?-------------------------------|--------------XE---X------------Eo------------------------?---------------E----?B--T--o----------B----M-----------?-------------E-|-----o-------T-------o
-X-----------------?-X---M-------X----M--T----B---||-T|-------------------TX----T-----------------T-|--M--------------?------|--X----------o------------M-------------M-----------o-------B|--T-X-?----M
---------------------------o------------T----------Xo----------X---B-|----------T--B---M-----M---------?X---------------------------?---------------o|-----o-M------------B----------------------B--BX-M
-?-B---E-E--T---X----------o-----B----------|-------------------------?--------------B------------o---|----------------T---E-----oX----------------o----?---------M--o--------T--------------|---------B
--------M-------|----------?-MT----------------?----------o----B--------|-|------------|------------------|-------------?-o?----------?------X----?---|----------------------X---------B?------M---M---|
---X-|--T----------------B--X--|-----------E-o--X--XE---M--T----------oB-XTX-M-T---oX---------------?-------------------T--------------T-o-------------T---T---------------------------B----------??---M
-----T--ET-------?X-----|---------o------------------BE-X------|----------------M|-----B--------------------M----E-------------M--------B-?----o-?-----------o--E--E----M---?-----X----------|----X---vM
--T----BT-o-ME-----oE-X---|------M--o---|o-Bo----E----|---|BEo-|-----B---M--o--o----M-M|-----E-Eo--|--M----X-E?E----E----|-?---T--|---------T---M------MB---?T-|--M----X----ETo---B--E-o-o?--BX----?--fX
---?--|--E--E-?--B-?-E-M---|-----X-T--M|oMT--------|-TB-M-B--M-B-?-------?---Xo-XE?--BT-X---To--o|----B--X-|T-------E--M---?-T----M-----M-----E------B-B-Xo----------o---ET----E---B-X----o-|-X-----E-f-
--X|-o---XM---T--------B-X-XM---B|--XXME--EB-B--Xo-BX-------------EE--E-B------T-----T--M----------|--|--?|-------B--E-M------M|-M|-B-TB-----X---T-M-B------------?X|?-?oE-T---X-----X--M---T----o-|--f-
-?---M-o|--Mo--B-M-o---XEMM?------o|---|---MX----XET---B---BMoM|-----T-B---X--T--o--------B-------------|B-------EM--------------|TT?----||--------M-E--o?---TTEM------EXE?--TM-|-EE---------T--|-----fT
--TBB-T-XT-B----T-----------o-XX--T-?E-o-------|-?----M------E-T----?X|M--X-oXo-----M--|-|XE----|T-|--EB?XT--oT-----?----X-T--X----?M------o-E---M---------?B--o?-T----T-?------B|------?X----|---|---fM
----X-B-|----|--EoE-X-E-?E|-o-X--------|?-|--M---X---B------T---E|-o-|-?-M-?---B--B----ETo?|--T?----?---T---?-------------T-X--|-Eo------o-----B-?----M-M-------|--Xo|BB---BM-X-|X-Xo-T--o---E-ET-----f|
m|---B-M|E-TE----M----------o--MX-MX|---|o--E-|-----B-o-X-X-||-M|-------M----B----B?XX----T--------B-?o?----X--M--MM?E--T--TX----------BE-o---o---X---M-T-----M--------TEE-T--E---------X?-o-BTM----X--?
XXXXXXXXXXXXXXXXXXXXXXXXXXXXXXXXXXXXXXXXXXXXXXXXXXXXXXXXXXXXXXXXXXXXXXXXXXXXXXXXXXXXXXXXXXXXXXXXXXXXXXXXXXXXXXXXXXXXXXXXXXXXXXXXXXXXXXXXXXXXXXXXXXXXXXXXXXXXXXXXXXXXXXXXXXXXXXXXXXXXXXXXXXXXXXXXXXXXXXXX
