-------------?-----------------------B---------------------------------------------------------o--------------------------------B-----------------------------------------------------------------------
-----------B----B------B-----o-------------------------------------------------------------------??????B?-----------------------------------------B-----------------------------------------------------
-----------------------------------------------------------------------------------------------------------------------------------B---------?------------------------------BBBBB--------M--------------
------------------T---------------------B------------------------?------------------?------T-----------------------------------T---------------------------------------------B------------------????----
------------------|------B---------o---------------------X---------------------------------|---------------?-------------------|----------------------------M-----T---------X---------------------------
-------X----------|-------------------------------------XX-----------------------------?---|---------------------o-------------|----------------------M-----------|----X---XX------------------------XX-
-------XX---------|--------------T----------------?----XXX-------------B--------------?----|-----------X-----------------------|----M-----------------------------|----XXXXXX---------------------------
-------XXX--------|--------------|--------------------XXTX---------------------------------|XXXXXXX----------------T?----------|-----------------?----------------|----XXXXXX------?--------------BBBBBv
-------XXXX-X-----|-----T--------|-------------------XXX|X---------------------------T-----|-----------------------|-----------|-----------------BBB----------X---|----XXXXXX-------BBBBBBB------------f
-X-----XXXXX------|-----|-------o|------------------XXXX|X------XXXX---B--------T----|-----|---------------------BB|B----------|-----------------------------XX---|----XXXXXX--------------------o-----f
-------XXXXXX-----|-----|--------|-----------------XXXXX|X--------?------T------|----|----X|---------------------X-|-----------|----------------------------XXX---|---XXXXXXXX------------------------Xf
-------XXXXXXX----|-----|--------|--------------?-XXXXXX|X---------------|------|----|---XX|--------------------XX-|-----------|---------------------------XXXX---|--XXXXXXXXXX-----------------------Xf
-------XXXXXXXX--T|-----|--------|----------X----XXXXXXX|X-M-------------|X-----|----|--XXX|-------------------XXX-|X-----T-X?-|--------------------------XXXXX---|-XXXXXXXXXXXX----------------------Xf
-------XXXXXXXXX-||-----|-------T|--------------XXXXXXXX|X---------------|XX----|----|-XXXX|------------T-----XXXX-|XX----|-XX-|-------------------------XXXXXX---|XXXXXXXXXXXXXX---------------------Xf
m-EE---XXXXXXXXXX||-----|---EE--||------E------XXXXXXXXX|X-------E---E---|XXX---|----|XXXXX|------------|----XXXXX-|XXX---|-XXX|---????---E-------------XXXXXXX---|XXXXXXXXXXXXXXXE-------------------XX
XXXXXXXXXXXXXXXXX||XXXXX|XXX----||------------XXXXXXXXXX|XXXBXXXXXXXXXXXX|XXXXXX|X???|XXXXX|---XXXXXB---|-XXXXXXXXX|XXXXXX|XXXX|XXX-XXX-XXXX--XXXXXXXXXXXXXXXXX--X|XXXXXXXXXXXXXXXXXXXXXXXXXXXXXXXXXXXXX
