-------o----------------E-----?----------------E-----------------o------M-------o--------------------------B------E-------------M-M-----o---------E----------------M----X---M-----o------Bo----------T--
----E------------B--M----------X-------------------E--o-----------X----?--BMBB?-B--------?----M---------------o-------------------M--------------B-----------E----?----------------o-X-------E-----o----
--------?-----B------------o--------------------E-----------o------------X-?-----------------o-------o---------------?--X-------------E-M-X---B-E-----------------------------------B---B-----M---------
---X-o-----------X---M----E-------------?----o-o--------o--?----------------B----------M-----X-----------------------?----B---X--------------o-X---------T------E--o----------?--------B----------M-----
-------X--M-------B-E-E------------E-----------o-----?o-M----------------------------o--?-----------E?-----------------------M--B-----X-B-------M----o-----E----------------X------oo----------M--------
---------------E----B---X-?----B---------------B---M----B-----------E------------E--------E---------------E-----------------------?--M--------------?-------------X--------E------E-o-X----B------------
---?----M-----?-----X-----BE----B-E---?--o----?-----M-----------B----------------X--E----------------o----X-----M---o--------Bo----------X--B-------------?---------B-------?M-M------------------------
------------X------------M------------?-------?--------?-----E-------------------B-----M------------X--M---B-----o------------------E--------X---------------------------B----------------------------v-
-----XX----X-----E-----o?--E----E--M-----M-X------?---?---X-------B-?--Bo--MX----oM---E-------o----o-XM---M------B-----E-???Xo-XX-B----E--XE---------X------M------X------X-------E---------?-o-Xo----f-
-------------o----B----?------X--X--E?-?--M------------B--XM-MB---E?----------oB----M-----E-?-------M-M-X-----E---B-------BE---X---o--oEX--------E?---B-E----MT----B---E?----------------o?-M--?--oM--f-
-----M---M-?--X--EX--------?-X----------oMEM----o-M-o-o----o--B----M--X--TET----E---?----BE--E---E----------BM-TM-o----EE--------oBo??BE-?---XE----X-B---o-?Eo|---M--MMM-o-T---X--B---Bo----oM---EX-X-f-
-X---------E---E---X--------?-----B-o---E-?------------B-----M-o----------?---o-----------M--------MB?o-------?--X--M---E-----------o--?--ME-----------M?--M?--X--oM-M-o------X---------------------?-f-
-?--BM--X----BB------------E-ME--X-----B---------BB--M--X-E?------E-E-o-B-X--oo--?-?E--EE----M-E---?-X--oB--?---Bo------B---------------M--E--?-o------?E---EXEME---o--B----X--BEE--oTM-X-X?--E---M--Bf-
------E--B-?B--------?-----------?--E-?---??E----To---?-XB---------XT---T-----X-M-X-X---X--M?-?-BX---E-MX-----?---o----oB-?TT-EEo-E----E--------------?---B-?--B--?B-----BB-M----T-XE--T--?-X---E-----f-
m----o--------B-T----||T----|-BM---T--E?|--T|-|B-|M|---M-B?X-----|-E|---|---T-M--E?B---BB--|--B--------B----T----|||-X--M-||||-?--B|T-|B----E-E----M-TM---------|--oo---M--------|M--?X|-XT-?--X--MT-Tf-
XXXXXXXXXXXXXXXXXXXXXXXXXXXXXXXXXXXXXXXXXXXXXXXXXXXXXXXXXXXXXXXXXXXXXXXXXXXXXXXXXXXXXXXXXXXXXXXXXXXXXXXXXXXXXXXXXXXXXXXXXXXXXXXXXXXXXXXXXXXXXXXXXXXXXXXXXXXXXXXXXXXXXXXXXXXXXXXXXXXXXXXXXXXXXXXXXXXXXXXX
