-----|------------------?---------|--T?-------E?T--M---------|--M---o-----|--o------B-T?X--------------X------|-----?-B-----M|---------M--------------oB--o-|---------X-------------T-----------T-E--X--
-----------------------|M-T----------X---------o----------------|--------M--X----------XM----?----------------TX------TT-----------------T-----Eo---o------------BE---------BX------------B------------?
-----------------?--o--o---------------|-?--|-----------------X------------M-----?---T-M------------------------------------B-------X-M---B-------E-E----E---------------|---?--M---------X------------T
-------E--BTX--------o-M--M-|--X-----M----T-oM--------------B?-?-------------|--------o|---o-B---------------?|--|---|--------------M-----E-------------X----X----T----B----E-E----------T---B?--------E
-X-----------o--------------T----?-----M---|--E-----------------X-|---X---------?---B------M---X-?-Bo-----X----E--?-------X-----------M---oM--M-T----|--------M----B-----------------------E-----?-----o
-|-B--------|----BE--X----o-------B-------E---X---------------o---Eo-------|------X-----------T-B?-----------------B----------------|---------X---|--------?---oT---------------ME--------------T--M---|
------X-----|X------M---M------?-T----------------------------T----------X-------------o-?o---T-----------o-------E------------Mo---------------------B------------------|-------------B----------|----o
-----M----o------T---------T----E-X---o---|--------X---oX--------|---B-----|-----?-|---?--------E----o--------T-----------E--|-E-E-----------?--B-------?-----------------------|B--o-------------E---vT
-o-|---oT|--B-BM-E--------M---M----Bo---o--?-X---|----|EX--E-MTT---T--Bo-o?-E-oX--oE----M--E----?T-E----T|-oE----MX----BX-|o--o---------MEX------X-?--|E--B-?---o-|--o-X|--B-M?|-?-----XX---MBMoo---EMfE
-----o-------MT-B-E--------|X---M--X?---?---X------MBE-B----------B?-EB---X-M------XT---TMM---X?---X----M-------?--|----T--E?----M--B--T-|o---E-----ooM--E-B?-----------B---T-MB-------TT-o-----E|----f?
-----Mo----B-oXB-T-B---?M--BE-M-?--X-|B?-E|--------T--------------TM-E--B-??--o-----------?E|----MoT?T---o--oE|--Too------X---M--B-----o-E----o-Eo--o---T---------X--E-|-o-BT||--T-?--?o-?-T--?----oB-f|
-|MMoT-o--MT--o-X-X?BM?---T--E-|?--------B------------M--?--X--|o--EB----T--B-o-?--------T--|-T--E-E---E-B---E--EB--o-------|XEX--B-?-----o------MB--B------o--T-oT---o--TE---B---E------o?-o---XT--o-f-
-|-T---o-?EB----X-??X--E------?--M----T---?----?---M------E-?BE---------|--T-----BE---TT----X------M?BE-EX--T---ToEM--M----EE-E-TM--o-----?-M-??--BEM?---oB-----E-B--|M-E-|?--|MM-------X----M--TM--?-fX
--o---o?B-T-oB----------X-oT-BM----M-|T-M?|o-B--oE------------T--X|------T------EBB|------B?--?EMo--TE-----T-T-BE----Eo---?M-X--?-------B--Eo----?-?----X--MX-T---|-MoE-----?M--o--EE--|--o-|--X--?---fB
m---?-|XX---M-T---B------|----XB-EBo|T?-T--MB------X?----?T--?M--Eo-B---|---TXo-M-E----|--X--|M--|-B--o--|------o-B-T--?----?--o-E---T-T-?-EM-T-------?B-oXM-----o-----E-o-T-E----------X---Bo---E?----B
XXXXXXXXXXXXXXXXXXXXXXXXXXXXXXXXXXXXXXXXXXXXXXXXXXXXXXXXXXXXXXXXXXXXXXXXXXXXXXXXXXXXXXXXXXXXXXXXXXXXXXXXXXXXXXXXXXXXXXXXXXXXXXXXXXXXXXXXXXXXXXXXXXXXXXXXXXXXXXXXXXXXXXXXXXXXXXXXXXXXXXXXXXXXXXXXXXXXXXXX
