-------------------------------------------------------------------------------------------------------------------------------------------------------------??-----------------------------------------
--------------------------------------------------------------------------------------------------------------------------------------------------------------------------------------------------------
----------------------------------------------?-----------------------------------------------------------------------------------------------------------------------------BBB----------------o--------
--------------------------------M-----------------------------------------------------------------------------------------------------------------------------------------------------------------------
---------------------------------------------------------------X--------------------------------------------------------------------------o-------------------------------------------------------------
---------------------------------o---------------M-------------------------------------T-X-----------------------------------T---------T----------------------------------------------------------------
-----BBB------------------------------------------------------------------------o------|XX-----------------------------------|---------|------------------------------------------?---------------------
---------------------------------------------------------------------------------------|XX-----------------------------------|---------|------------------------------------------------?--------------v
---------------BBBBBBBB-------T-------------------------------------------------------X|XX-----------------------------------|---------|---------------------------------------------------------------f
------------------------------|----------------B-----------o--X----------------------XX|XX-----------------------------------|----M----|---------------------B----------------------------------------Xf
------------------------------|-------------------------------XX--------------------XXX|XX----------------------------??????-|---------|------------------------????-----------------------------------f
------------------------------|-------------------------XX----XXX---------------X--XXXX|XX-----------------------------------|---------|----------------------------BBBBBBBB---------------------------f
-------------X----------------|-------------------------------XXXX-------------XX-XXXXX|XX-----------------------X-----------|--X------|-----M---------------------------------------------------------f
-------------XX-B-------------|---o---------------------------XXXXX-----------XXXXXXXXX|XX-----------------------XX----------|-XX------|----------------T----------------------------o-----------------f
m-------E----XXX--------------|-----B-------E----B----------E-XXXXXX---------XXXXXXXXXX|XX----------E------------XXXX--------|XXX------|----------------|----------------E---------------E-------------X
XXXXXXXXXX---XXXXXXXXXXXXXXXXX|XXXX-----XXXXXXXXXXXXXXXXXXXXXXXXXXXXXXXXXXXXXXXXXXXXXXX|XXXXXXXXXXXXXXXXXXXXXXXXXXXXXXX--XXXX|XXXXXX---|----XXXXXXXXXXXX|XXXXXXXXXXXXXXXXXXXXXXXXXXXXXXXXXXXXXXXXXXX---X
