-------------------------------|-----------XE--------------------B------T-|--------E-------T--------E----|---------TB--E-------------------------------X-----|---E----X-----------|o--T--M-------M-----M
--?---------B-------------T-------X---M----o------------T----|---ET?--M---B---------|------?-T---o-----B----------|-?-----------------------------------|----------------------o----E-------|----------X
-----------o--------?-----oT-----E------E-------|-------E-|-----------------oE--------o----B-------------------M---M----?---|---------------------------------------------E---X-M-------X----------E---o
--------o--?---X---------------------o-X-------o----?------------|-XT---------------------------------|-M---------------|---------?--------?--------E---------E----------------------|----------o------E
------------------o----?---X--------B-----------?-X-------M-o?---B-|---|-M--------------B-?-------B---------------|E-------------E--M-----------T-B-o--------X---X-----|--X---------|---Mo-------------B
--T--------------XB----o------o--X--------B?--------o----E---E-------B------------------|----------------E-----X-----M---------|oB---M-------X------T--------------XB---------------T---?-B-EM-----|---T
--X----------M-------|--------B----------B-------------T-------------?----------------------B--------M-----T-----------------E-M--M----------------------M---E---E--X---------------------?-----X-M--B-|
-------------oT-------------B---T-T----XX-----------o--------|------------------------------B---------?-E------------|X---------T---------|---E----------|--X-M----E----------------X-T-----E------B--vT
-TETo|XM--M---o--oT-E---o---?---M---------T--|o?EE-----?-E-------?X-M-T-----o----BMETXo----|---X-o-?-B|X--?-|M-E-B----?M|--T--E--E-Xo--|T-TM--M--|-XM--B?--|-----o--EMB-XX-BT---M----X-?--T-----B-----fB
--M--T--M---|----X--TX-E---------B-o|---|----o?|---T----E----------EB---X?o-M--M-----M----TM|--------------X---B-EoETTXT--M--oE--M?-B-BB---X--oE----B--M--B--?---E--B-M-----B---X-E-oM--------|--B|MB-fE
--E--E-E--E?-T-|-E-B---X-M-B?-o-|BoB---BB---T-o-----M---B--E---M-B-T--?----?o-oT-E-X-M---XTB----?M-o-|------EM?--E---------T---T-----M----B-T-X-B---T----?---------?------oB----X--B-B----o---X--XMo--fT
-o|---------M----o---XE-|-E---oo-o-------------X?MBT--o----T---?--oE--XBX--?-|-B--o-o------X--BBo-M-?E---?oM--BX-----|-|-----------|E---M------------MB-|--o-?-T--X------X?-B----o?-?---B-TT-MX?M---o|f?
-o----M-|----M-o-MB-T----E?-B-?E----oE---?---o-XT---|MXXEo-T---------?---------X-B----T-M-----E-T---T---oXM--E-M----M---------T----o-|-MX|T?---B-----?--------------TXB-X--M-M---T--M-?---BE-M----T---f?
-XMBX----BXE-B--BX----B--E?oo-?-?-o-----ET----E-|----T-------E--TMEE-X|--o?---o-----|-o--oE--ET|TB-?--o-?-----MB--X---M-------XB--Mo|--MMB-oM-M--|-oM--MTX-?-----------M-o--?-B-------B--T?o-B|---|-o|f-
mo----B----------|-E-M-----------?-M---?----E----B-EXM--------XX-o---?B|--|------M-|M-?--TX----o--|----X--?X----oBB?-M-oX-o--------T|E-Bo?-?----|----?-E-B----To--oT--o--o-BM|-----X-B-----E--B-MX----X?
XXXXXXXXXXXXXXXXXXXXXXXXXXXXXXXXXXXXXXXXXXXXXXXXXXXXXXXXXXXXXXXXXXXXXXXXXXXXXXXXXXXXXXXXXXXXXXXXXXXXXXXXXXXXXXXXXXXXXXXXXXXXXXXXXXXXXXXXXXXXXXXXXXXXXXXXXXXXXXXXXXXXXXXXXXXXXXXXXXXXXXXXXXXXXXXXXXXXXXXX
