--------------------------------------------------------------------------------------------------------------------------------------------------------------------------------------------------------
------------------------------------------------------------------------------o---------------------------------------------------------------------------------------------------------------------X---
----------------------------?----------------------------------------B----------------------------------------------X-----------------------------------------------------------------------------------
--------------------------------------------------------------------------------------------------------------------------------------------------------------------------------------------------------
--------------------------------------------------------o--------------------------------------------------------------B------------------------------------------------------------------------------M-
-------------------------------XXXX------------------------------------------------------------------------M--------------------------------------------------------------------------------------------
--------------------------------------------------------------------------------------------------------------------------------------------------------------------------------------------------------
-------------------------------------------------------------------------------------------------------------------------------------------------------------------------------------------------------v
--------------------------------------------------------------------------------------B---------------------------------X------------------------------------------------------------------------------f
------------------------------------------------------------------------------------------------------------------------XX-----------------------------------------------------------------------------f
-----------------------------------------------------T------------------------------------------------------------------XXX----------------------------------------------------------------------------f
-----------------------------------------------------|---------------------------------------------------------M--------XXXX---------------------------------------------------------------------------f
-----------------------------------------------------|------------------------------------------------------------------XXXXX--------------------------------------------------------------------------f
-----X-----------------------------------------------|---------------------------------?--------------------------------XXXXXX-----------------------------------BB------------------------------------f
m-E-XX-------E---------------------------------------|-------------------------------------BE--------E------------------XXXXXXX---------------------------------------------E------------E-------------X
XXXXXXXXXXXXX----XXXXXXXXXXXXXXXXXXXXXXXXXXXXXXXXXXXX|XXXXXXXXXXXXXXXXXXXXXXXXXX--------XXXXXXXXXXXXXXXXXXXXXXXXXX------XXXXXXXXXXXXXXXXXXXXXXXXXXXXXXXXXXXXXXXXXXXXXXXXXXXXXXXXXXXXXXXXXXXXXXXXXXXXXXXX
