-oT-E----------------oB-------------------------------------------B------E----|---------T--------o-o---B--M---X--TBE--------------E----T----------MM-?---ET--T--B--B--------------------ETX----M-------B
-|--B-X-----B-X---------T-o-----------------X--M-----------|----------|---------------------|---|------?--?---------------------------B-B----T---------------?-----------T---------------?-------E-----B
-----------------T--------T------o--------------------X--B-|-----M|----Mo-------M-o------|---o--o------|-------T---------|----------XT-------------?B---X--TT-------------M--M-------------------------B
---|------X--------------oE------------------|------------?--M------------T---X----------M----------------T--------------B--|------X------B-o------o-M---------B--BT-----------E------------o----o--?--B
-----------M------------------------B---T-------B---E---?-----------------|X?----T-------X?E-X-------------T---MT------------------------BM--------------E------|------E|-?--X------------------M------E
----------|--T--E-----?-----------?-o----------------------X------B------------------?---B------------B--T------|---M---E|Bo|--TM-------------------E---|------|-------------------------E----E--------E
------------------M--?B-T-|-----------o---X----|------E----------------------------B-----T|--o----E----------------------B--o--------------MT|---B-----X---?-----------o--?---B--o--E--------X---?-----T
--TE---------?-----------M?-?-M----------------------M--------X----------------------B--B-------To---M---E-----M--------------?-----|--------------------T----X---------------Mo?------?--------------vX
------B--M----BM--M----|--o--TE--M--?------?-XToE---B-|M---?----MM-T-|-E?--BM---X-XoT--BM-o--?B------X-T-X--?|X-M-------o-M----MoM----o?----M------?---B-B--T-o--X-E-X--MXTT--EooTT---BM----E--B--E---fo
-----B--?-T--M-----B-?-E--X-B--||T--To--o-|--E--X--?-T--------To-E----?--M----X-T--M-|BXETMTX-X---|-|M-M---?|---o-|--B?-XBM--X|X-|-|E-----B---XB|X----B----M-M--T--o---MT--oT--|--T-o----M-------o-ET-fX
----E----BX--Eo-----B-|o|---?------oMTXo-|X?TBB--X-|--XTB-oM-----?E--||-M--|-o-BE|-Bo-o-|XM--B--o-?--XXE---X-o-----?-----------?----?----o-?-E----XT-X--E--B--XM-B----TM-?-----M-T--TE-B------T-T-B-MMfo
--T-|---------?X------?--?E---?-------?To-X---?M-|o-----TM---|o-?B-T--------?--?-XBM---?T??M--TM---------E-?E-MT-----MT-MXo---TTT|M?--E---o-|-?EM-XM---TT-|----?BM?EX---XXE---------MX---o-E-----X--B-fT
-|----B?o-----XEB--o--o----X-?----|-?----B---EEX---ME-X-T-E--o-BB---T??--?---XB|---o---X-M-E----M-M----?--o-M----X---BTB-Eo----MM---?o--M--oXoT-?-----T-----|?--BTo---M---E------X--|------X|-B?--M-o-f-
--X----o--o----|-?B-?--M---------?T|B-M-B-o---X|-B------X-|---?MEB--X-|X--T-X----T-?X----E-EME--B--ToM-E---oT|--oXE?oTB------E--o--E|XBT--XoX-|-o----M------T?T--|----E--M-------|T-EE-o--E----o-----Efo
mE-o---T--EM----o----o-T------B?--T-oB-o--------X-B--B---M-|?---M||--B----EM------o-X---|----E-T-E--BB-TT-----E-oX----?-------BM--Bo--B--E-M-X---TTo--||--?EMTT-o------T|B-B-M--B----B--o-X-M--Xo---M-Bo
XXXXXXXXXXXXXXXXXXXXXXXXXXXXXXXXXXXXXXXXXXXXXXXXXXXXXXXXXXXXXXXXXXXXXXXXXXXXXXXXXXXXXXXXXXXXXXXXXXXXXXXXXXXXXXXXXXXXXXXXXXXXXXXXXXXXXXXXXXXXXXXXXXXXXXXXXXXXXXXXXXXXXXXXXXXXXXXXXXXXXXXXXXXXXXXXXXXXXXXX
