---o--------EM------------oo----------o-----E?-------?--M--------T------|---M-------------------------BTE---B-------B------E--?-------E--------------------?---------------------------------|?----M?--o
-|--|----------------X------------------M-----|---M-o---o--------E------------------B-BX------------B------?---------------B--M---oX---------|?--|---?-----T----T--X----T-------------------EB------o--T
--E---------M---------T----BE---T--------------M----|--------M---T--?----E-------X---------T--------|--T---|-----?-----------E-----E------EB------------------|--T----------E------o--o--o---B--?------?
--o--M------------B-T-------X----|------------------T-X---------------------?E-----X-?-?---M----------------M----X-------X------------------------?-----o---M-----M-E--------o------oM----------BM-----X
--B---------------------M----M--B-----?--E------XT---------------EX-?--B--------------E------M------o-----------o--B----|-E------------T-X?B---B--------------------M--------------o?--XB-M-X--B----o--B
--|---B------E---T---?----B----------M---?--X|--E--X----E------------o--X---------------B-----M|----------?----E---E-----------T------X---X-X-To------------------E----------|------------------X----X-B
-----?-----M-----T----|-----------------?--------------------X----E-------------?T-X---X---|--X-BE---------?-oMo--------------M--E---??-BX---------B------B-------------------T----E----X----?T-M--X---o
--------X|-----X----------|----------?----EB--M?-----------|----T-------T--o---X----|-M---------------X--E--E-------------?|---T-------|------------------X---T---X-------X---B----|------------------v-
------MT-B-B?----M|Eo-M-?------|----B--T--B?---X-|T-----E-B-MMBEEM-|M---o--B|---------o-B------ET?-To-X-M---M-----?-T--TE-|TEX-------|---XM--EM----M|?-M---M-----?X--XM--M-BoE--T|---XT-M-TM-TB--XXM-?fE
--X|-oo----B-EB-----E-------------BBEE-?E--Mo--BX--E-?|---X-----M?----B--|---E?----B--------------|---------|-XoEB--|-----MMEBE-XX----o?-MBM-o----B----o--E---?MMo------o-?-o|-------?----------------f|
---------o--T-T-oT-B|--o----|----B-|---M------T--M-B-M-TM--EXX|--?---X|M-----X-MT--oBT-E-T?------M-----EEB|-?--|-|MoT-B|--|-BX---o--B--B-?-?---------M--T--Mo----T-X|XEBo--------|-|T----------------Tf|
----BBX---Eo----M--?-B--X-X-X-M-M-o--M----T--------|-|-XE----o--T-?--B----?--E--TBo---E----------o-----E--|----B-M|M----X--BBX--?B---|T--?-Bo??-----E--B--T-EB--Xoo|---|T-|--M-----?o----------M--BT--fT
-----XB-M-E--?--E--B---Mo-B?Eo-M---?B-X?|M---M-M-|B-----X--o---T--||------|-----?--E-T---E-oM---T-X----M----M--MT-Bo-o--MoT--M|--?-T----?-X|---B?-|X----X--X-M-----|-T-T---?o---o-X--o-o-----?|BT--?T-fM
-E--?---X--?E---M-B-oo---Mo-----B-|M------?-o----B-|---M?-----B---?-|----B--ME-?-E--X-?-------ET----M-M?-----T--------?-?--E---T-----X-----MB--E-------X?T-----X---|-o-T-X-E--E--|----------------T-T-fM
m-|----E-T|?--B--M|-T---E--XT-----o--?XE--E---TB--X----------M----o---ETE--TT-o--E---o--E-M----B-------E?----M-----o--|?--o--o-??M--------?-|--?--E-|B-|---o---?M--oo|o----o-B-T-------MB--T-----------M
XXXXXXXXXXXXXXXXXXXXXXXXXXXXXXXXXXXXXXXXXXXXXXXXXXXXXXXXXXXXXXXXXXXXXXXXXXXXXXXXXXXXXXXXXXXXXXXXXXXXXXXXXXXXXXXXXXXXXXXXXXXXXXXXXXXXXXXXXXXXXXXXXXXXXXXXXXXXXXXXXXXXXXXXXXXXXXXXXXXXXXXXXXXXXXXXXXXXXXXX
