---------------------------------M---------------???????--------------------------?--------------------------------------------------------------------BBBBB---------------o---------BMBBBBB------------
-M----------------------------------------------------------BM------------???????--------------------------------------------------------BBBB-----------------------------------------------------------
--------???-------o-------------------------------------------------------------------------------------------------------------------------------------------------------------------------------------
-----X-------------o--------------------------------------------X-----------------------------------------T----------------------T------------------------------------T---------------------------------
-----o----------------------------------------------------XX----------------------------------------------|----------------------|------------------------------------|--B------------------------BBBBB-
-------------------B---------T---------???T????--------------------------------------------------------?--|----------------------|------------------XX-------------X--|---------------------------------
----------------T------T-----|------------|---------------------------------------------------------------|----------------------|--o---------------X-----------------|-----------------------XXXXXXXX--
----------------|------|-----|------------|------------------X--------------------------------------------|----------------o-----|-------------------o--??------------|-----------------o------------X-v
----------------|------|-----|--------T---|------------------XX-----------------------------M-----------??|?------T--------------|----------------------------------?-|-----------------X------M-------f
----------------|------|-----|------X-|---|------------------XXX----------------------------X-------------|-------|----X---------|---BBBBB----------------------------|-----------------XX-----X-o----Tf
----------------|------|-----|------XX|---|------------------XXXX--------------------------XX-------------|-T-----|----XX--------|???o??----------------------???-----|-----------B--?--XXX---XX------|f
-----------T----|------|-----|------XX|---|----------XXXX----XXXXX------------------------XXX------------X|-|-----|----XXX-------|------------------------------------|---T-------------XXXX-XXX---M--|f
-----------|----|------|----T|------XX|X--|------------------XXXXXX----------------------XXXX------------X|-|-----|----XXXX---?--|------------X---------------X-------|---|-------------XXXXXXXX------|f
-----------|----|------|-X-T||------XX|XX-|-----------------oXXXXXXX-------T-----------TXXXXX------------X|X|-----|----XXXXX-----|------------XX--------------XT------|-T-|-------------XXXXXXXX------|f
m----------|----|------|XX-|||------XX|XXX|-----X-E-o--------XXXXXXXX-EE---|--------o--|XXXXX------------X|X|-----|----XXXXXXX---|E---------X-XXX-------------X|X-E-E-|-|-|-------------XXXXXXXX------|X
XXXXXXXXXXX|---X|-----X|XXX|||----XXXX|XXX|XXXX-XX-----------XXXXXXXXXXXXXB|BBBBBBXXXXX|XXXXXXXXXXXXXXXXXX|X|XXX--|-XXXXXXXXXXXXX|XXXXXXX--XX-XXXXXXXXX-XXXXXXX|XXXXXX|X|X|XXX----X-----XXXXXXXXXXXX--|X
