-----X---------o-----o-M--oX--M---------------------------------------------------o--------------?--------B------M--M-X-E-------BE--o-B---------------E-------------------B--X-E--M---o--T----------|--T
---------------------------BM?o---X-E--o-----------------X------------E----E----|------------T------E-------B-------------------------------------B-----------|-----T---------------------?------------X
--T-------------?---------o---B--X--B-------E-------?---------B--------ET-B-o-----------o------------------|----E--------M------------------o--|--------X-T------------------?-----B-----E-X?M---------X
---------?---B---------------------o---X--M----X------B----B-----E---T-o--EX--------|o-E-------XXo-|-X--------------T---------------o------------------------M-M------------EB--M------------Xo-B------?
--X----X---X-E--?-M------------E---------BT---------E-------------M--T-------------B--E--------o------|--oXM--X--------T----|---?-----------------BB--X-----X--------------------Mo------E-------------M
--X--X-T-BT--------?-------------X---------T--------------------E-------T-o--------X------B---------B---MT--?-----?-|--?-------------o-------------T?------------E---E-T----------------|T------Xo------
-oE----o---------|---oB-------------T--E-------------------------------------B-o----------X------------X--?----X---------------|------------------o------------------------o?-|---------|----------M---B
------------o-------------T---------o---------T-X--E------------|---------E-o-------M-------------------------|----------E----|------E--oE------------E------E---------?---|-------|----------B-------vB
-?--M-----EBB---|----X?---------ToBTT?||-E-o----X?--M-MX-o--|---o|X--------------?-B--------|-M---T-----M----E-----o---T--M?---?----T-XM--o--TE-X--E------MX--?o---B--M--?|E-o----M--M-E-?------E-B-X?fo
-M-M--|-E--o|--o-T---?----|--X-B----E?--E--Xo---T-BX---?|-------X-TB--?|---B|------B-T--B-o-----------o--M--XM--E-|E------|M-o--X--T-E----B----?--X--|T---E-|-E----T-BTM--?---M----TM-B-||?-T-E---?---f|
-T-MX-M------?---E-E-------M-?-E-T|oMM??E---o--Mo-TM---XMTX--M-o------BM----?o-BT----B--|----|--M-|-----E--|Xo----E?-?--X-T|-|--?-?-|---MT-----|--|--------TB---oT|-MX---oX--o---EXBX---|X---Eo-----MXfT
--M--X-E-B-----EE---T---?-------|XT------o-?TT---XX-|-T-oM----T----?M|---|-----E??o--?|B-BBBM-----X-BB--o---?-oM-----?-X--E---?|-T-B-B|-T-MX-------?----M--?XX--o-o---?---T-X---?|o-----?----|----T---f?
-----BM-MM-X-M---E-X-Eoo-|-o------oT?----T--|-----T-?-|---E|-|---T-o|--BT-E-o-oXE-?o-?-?---E--BEE---X-o--o-o|--XT?-T-T-E-E-M------|-T---XBM----B---|-E-??----X----T-M-o--M--M--ooB--M---X--B|-E-----TEfo
-------o-XBB---B---------XB--|?-EB---X--E-oT-X--EM-X-o----T---M--o-o-B-----B-o-|---|---|ET-|--T-BM-o-BMX----M?-E--?-----?-o---X-??-??|---|---|-EE------?-E--EX------T--B-|--------X-To--B-M-----B|-T--fo
m-E------|---X---E----BE-|---------o---?-oB--E|o-TT-?--|--|-------BB----?-------|--T-X-E-T--E-BB---M----T-------o--|------T----E-----T-B-M----?-E-B-M-oT--B------|--B----|-?M---XX-T|-B--B-|XEEo-TEo-M-|
XXXXXXXXXXXXXXXXXXXXXXXXXXXXXXXXXXXXXXXXXXXXXXXXXXXXXXXXXXXXXXXXXXXXXXXXXXXXXXXXXXXXXXXXXXXXXXXXXXXXXXXXXXXXXXXXXXXXXXXXXXXXXXXXXXXXXXXXXXXXXXXXXXXXXXXXXXXXXXXXXXXXXXXXXXXXXXXXXXXXXXXXXXXXXXXXXXXXXXXX
