------------------------------------------------?------------------------------------------------------------------------------------------------------------------------XX-----------------------------
------------------------------------------------------------------------------------------------------------------------------------------------------------------------------------??------------------
--------------------------------------------------------------------------------------------------------------------------------------------------------------------------------------------------------
--------------------------------------------------------------------------------------------------------------------------------?---------------------------------------T-------------------------------
-------------------------------T-----------------------T----o--------------------------------------XX-------------------------------------------------------------------|-------------------------------
-------------------------------|-----------------------|-o-----------------------------------------------------------------------?------X-----?-------------------------|-------------------------------
-------------------------------|-----------------------|------------------------X------------------------------------------------------XX-------------------------------|-------------------------------
-------------------------------|-----------B-----------|------------------------------------------------------------------------------XXX---?---------------------------|------------------------------v
-------------------------------|-----------------------|--------------------------------T--------------------------------------------XXXX-------------------------------|------------------------------f
-------------------------------|-----------------------|--------------------------------|-------------------------------------------XXXXX----------------------B--------|------------------------------f
-------------------------------|-------X---------------|--------------------------------|-X----------------------------------------XXXXXX-------------------------------|------------------------------f
-------------------------------|------------------T----|--------------------------------|XX---------------------------------------XXXXXXX-------------------------------|------------------------------f
-------------------------------|-------------X----|----|--------------------------------|XX--------------------------------------XXXXXXXX---------------X---------------|------------------------------f
-------------------------------|-------------XX---|----|---o----B----------------------X|XX-------------------------------------XXXXXXXXX-------------------------------|--------T---------------------f
m-------------------------E----|-------------XXX--|----|------------------------------XX|XX------------------------------------XXXXXXXXXX-------------------------------|--------|---------------------X
XXXXXXXXXXXXXXXXXXXXXXXXXXXXXXX|XXXXXXXXXXXXXXXXXX|XXXX|XXXXXXXXXXXXXXXXXXXXXXXXXXXXXXXX|XXXXXX-XXXXXXoXXXXXXXXXXXXXXXXXXXXXXXXXXXXXXXXXXXXXXXXXXXXXXXXXXXXXXXXXXXXXXXXX|X------X|XXXXXXXXXXXXXXXXXXXXXX
