------------B-------M-o-BX--EM---o----o----E-------o-------------B-B-E-------?----------------------------oo--o-------------------?-------------o--E--------------------M-----------M-----------B-----?-
--M-------------------B---M------------------?-M-B-------Xo-----------BE----------------------B---B-------Bo---X?-----------EM------B-----------o-------E-X--E--------------------E----o---E------------
-?--o-----o---M----X-B-----------?-E----?-E--------B---------B--------------------EX----E-------o---o?--E--?-o--X-oo--------M--E--E-----o---?---B-----E--X---o-------------------o---M---------E-----E--
--?-----------------------X------o--------------E----------o----------X---------o----X----B--B-----------B?-----------E------?-----M---------------E--M------------------o-----?--oM--------oX?---------
----B----------Mo-----------o------------B----E------------------XM------------o------------------B-o-EM-------------------M--------B?-X--------X-------B--------?-B-E-----E----------E-----X-----E-E---
-BM---M----?----------E---?---?-----X---B-------?--------E----------o--------M------------------------B-----oB-X--------MX---------X-o-----E-o---------XE----------E----Xo------oMM---------------------
--------M-EB---M--------------------?----------------------X--?E---Mo------------M--E-------------B-E--X-------------------?-B---oX--E-----------E-------------?E------M---B-B------MB-----------B-o----
-----E-----------X?-?----?---B?BB-B---Bo-----------B---------------------X-M---XEM---------------o-----B---------------------------o-------------------E---------------E--X?B---------o---------------v-
---MM--oo--------E----?----Bo?-----E---?---E?---X--?----E----EM-------X-----E-----B-E?------X------B---B-?oo-------------M-M----o?-M-EEM------------E---E-oM-------B-Bo-o----E?------?--E--?-EE-EM-MX-f-
------X-M--MM------ooE--X--ME---?-oE?--X?-o---M--o-X--X-?--X-o----o-EMBM--E---------o----?--M--M-?--M-?M-----XX-------B-B--o----EME----B------MB-E----X--BX-----------XX-oX-X-----o--E--B---MB?M------f-
--XX-o-?--------E-------?---M-E--BB----------B----M---o--?X-----?-X---o--M---------o-ME--?X-B-oooB--?E---E--------M----XB----------M-oE------M-----X------------X-E--E-o--?-E-----Mo------BEM----BX---f-
-B------o-M---E---BM---------M---o----oM-?B-o-B-?-----o-?---o-EEo-----X--EE-X-?----?-E-----BX--o------X-B?--?X-MBX-B----------E--MX-M?--?-B--M-o--B-X-M--B----oo---B-o-E----?------?----------X---B---f-
-B--M-X---M-XB?-------------X-----X--E---?---X-XE--E-?BMB---------M----?-B-X-EM-oXBM-E-----E-?E----X--------?---M?-M?E-E-----M--Eo-o--E-M-?---------?M-E-B--X----o-------B---M---?------M?B----------Bf-
--TM-E-T--T-TT--T----T---T?T-TT-B-oT-?T-TT-MXT----?T-M?-TE-TT?T-TTTM-TTTTT--?T-MEoTT?M--?T----E-T----TM-TTXT-E--T-T---T-T--?-TTT-T-T-TT---ETTBTTT---T-o---TTo-----oT--E-TTTT-----X-TTTETT-T-?ET-T?-T-Tf-
m-|-o-o|-B|-||--|---?|---|-|-||----|--|o||--X|XTo--|---X|?-||-|-|||?E|||||-o-|-|-o||X--?B|--?---|EM--|TE||||----|-|---|-|----|||o|-|-||---|||-|||--E|oB-B-||---o---|||--||||--|----|||-||-|--E|-|-?|E|f-
XXXXXXXXXXXXXXXXXXXXXXXXXXXXXXXXXXXXXXXXXXXXXXXXXXXXXXXXXXXXXXXXXXXXXXXXXXXXXXXXXXXXXXXXXXXXXXXXXXXXXXXXXXXXXXXXXXXXXXXXXXXXXXXXXXXXXXXXXXXXXXXXXXXXXXXXXXXXXXXXXXXXXXXXXXXXXXXXXXXXXXXXXXXXXXXXXXXXXXXX
