---------?T----o--X-----X-----------M-------?-------------X------T-----M---B--B----------------E-----X-------o--M--?--X------------X-MM---------------------?-----------------?--M-------------|-------o
-----B--TT--X----?---------|-------------o--o----------X---?T------------|-------o------B--B-o------|---EE---E-o-----o---------|----?------------------?-----------------B----X-----T-T--------X-------X
------M-----E-M--------M----X-----?-----X----------|X-----|---M-----B-E?--------?-B-------------?----T---E---|-T-----------?---T-----T--------B----------X-E------M-o----?---------B---------------B---?
--------------?-ME--X---E---------T?----------B----|------|-------T-E----TT----o------------E------|?---------o----------------------------------------------?--------T---------------X--------------?-o
-M|-----o--o---o--E---------|------B------M------B-------B-----E--|--------E-X------?--o----------T|-B--T-----------M-E-----------------X----M-------E-------M----?-----------T---B------E-------------E
---EE----o-----E-----|----------o---M|--------------B----------------?-T----M---?----X----oM---?---B------------B---B--XME----------------------------?--|-------------------|--o---------M-M?---------E
--X---------------------B----|-------------------o-----T------|--|-----E-----------------|---E--------------B--o--|-------B---------T--------------|----T------------------ME----------------------B----
-X-T-M---------XT----M------------B-oB----------B--------XoT------B-M---------?------------------X--------------------o-----TM-X--X-----------------B-B?--|---E-----?-------------|-----------T-?-----vE
-X---X---B-T-----o-----T--o----Xo|-?-E-E|---B-To---|T-X-X--X-B---?oX----|--o---?-oX----?|---E-----|---M-Eo-o--------|--E--o-E--ME-E----BE?----|----oo--XTM--T-X-B--E---B---------M-o---B|M--E----B-|-MfM
----|T---E-|?-----------|--|--X----B---|?E---o-E-?-XM-BM-E-B---E-?----XBEMT?|o-------?--BT-B------o----T---M--Mo-M----?EXo----BE-T---T-----|-M--------M-?|M---?-|----|X----?---?M?-?B---MX--TT---?--o?f?
-B?----|-?-|-M?---B-X--E-?---TX-o--o|T------?|?---B---B--EE-----|-E--|M--XT--?--BTMEE-T-oM-----o-T------|---o--X-ToBB-MME?-|-|-X-?-M-E--EM-MM--|--MBX--BTX-T-X-oB-----T----X-------X---M-|----X-o-----fo
----EX-----M-B-T---?B---X---XX--T--T--|--E-E---MX--T---?----|B--|TM----?---X-?-|B---M----M----|?B------T----------E-?---B|--|-----B--|o-B--o|T-M-BMM-|-BET----M---?-X----ETB---------oT--?--BB---oTE-TfB
-EB-----E--B------TE|---ET-?--XTMX-T--TBE--E--o?M-?--E-M-X-----T-------B-?-?X--E-??|?-TM-o-M-E--X-TTT|?E---T-E-|B?-TB--B|-|--o?---BoB----|M-XBo-----?o-E?---------?--MEBE--X-X-o----BM--TE---------?--f?
------X-?-E--?---T-E?-T-?--B------oX-----o---MM-E-XT-B--E---M---TE-T--XB--------TMo-E--E--X?-?---o------T-----?--o--?--|-B-------?-X-?-|-?-?-|X---o--------T---M-o-M-o--|--M-EM--X-oX---Eo-X|--------TfB
mM----||--o-o---o--M-BTMoB-------ME-B-|B---o-MBTXT-E--T---B|------BE----o--?--X----?-o----E---XX-?-o---o-|--o--E|B-?---?-E|X--X|-B------o-oo--M-T------X---?E-X|-B-B-------XB------------To-?--B---X---T
XXXXXXXXXXXXXXXXXXXXXXXXXXXXXXXXXXXXXXXXXXXXXXXXXXXXXXXXXXXXXXXXXXXXXXXXXXXXXXXXXXXXXXXXXXXXXXXXXXXXXXXXXXXXXXXXXXXXXXXXXXXXXXXXXXXXXXXXXXXXXXXXXXXXXXXXXXXXXXXXXXXXXXXXXXXXXXXXXXXXXXXXXXXXXXXXXXXXXXXX
