------------------------X---------------|---------------M-----?-----B----X--------M---E------E---------EX-----------B------B---E--------------------X|-B----?-E---|----------o----------------X---M----|
---------X-----?----|-----------T----X---------X--------T-T---------o--X-----|----oX-----?E---------------?------|?X----X-----------T?------B------------------|--o--------------M------|---|-E?-----B-M
-M-E-----------M--?M----E---B----E-E--|-----------M----------------T------------B---|-------------X-M-B---E-------T-B----------o-?------B--------XB------------------B---------X|-------------------M--E
-------o|----o----B---T-XX---B---------X-------T-B--Eo-----T----T--M-------------T-E---------------M----o----------------Xo-----o------E---------------------------------------?-------------------o---M
--------------------------o--M----------X-------------|--X---B-----T--------------?---B--B-E-o---X-----T---------?----------------------?X-E-X---------M-B-----T--MoX-------|-M--E|---------T?--?----o-B
--?--|-B-----------|-----o----|--------------------------o----X|--M---E----------------------------------M-Mo--------M----E|----|---X---B-------------B-B--------E-B--------o--------------B-----------?
------M----------------------M-?X-----------E---X---------BE--------------------E-----E------?---o-------B?--------T----E---X--E-----?|-----B-------------------T----M----X----------|-----------o--T--X
-X-|-------------o-|--o?|--E-B--T?------M--|E---------|---oM-----------B-------------o--------------?-------oX-E------X-B--------?---T----------------X---X----------------------------X-------E------vB
--X-------o--T---X---o--B--oXXE?MM?--EE---------T|------Xo--oM---|M-------B-X----M-?--M|---MM---o--E-?-----o-|BMX-M-TToM|-----TMo------?-E-----X---T---TTB-o--X?---|M--T-?--|------TM--T------T-------fX
---TT|TTB-X---|---|-----?-----o------B---oXTM---o----X-?-?--------MT?M----E--T-------|-E-----||---XMX?oMXE?M-|-BX--E-M?X---E--E---E-|------M-M|o-T---T?-------BoE----X-X-T-----o|?MXE--------?M|------f?
---|-B-E---MoT---?-B--M|M---T-TM--X--?--?-|---?M-----?-?X-X--|----|--?---E?-|o-o-T-?----M|-EB---------X----T-X----B-B--BT-BMEX?--Mo-----B|-ETB---T-----B---T-o-oo-|----X---X----?B-B--M-|B-?--o-B--BE-fX
---E-TB-|X-T---ET----B|-|--E----BXBM-X------E--X-MEBE----o-M--T--|-M--T-----XBE|X--X--------------?-E--------?-M---M--?BT--?---X?---|--|--o?------TX?-BX-------MB-----Xo----M---oB-----M-o-----M-oo---fM
-----E----?---|-??M--E--X-----o?---|BE-ME--ETB--|------?X-B----?--?-------|B|---?T----?---M--E?--T----|?--------B---E---X?B---o----------B------|-B-oB--B-------o----B------M---EE-------E--X----B--oMfB
---------T?---o-M-M----?---ET---E|-|M------B-X--XE-MM-TT--X----XoX----|-o-TX|T-?B-E-MoEMBM-M|--?M-------E-?----T--|-|oEEXE-M--XT|--B---o?-------?----M--B--o--------X-o-o----|-----BB-------|-|--|---Xf|
m--?----XEX---M?-E-?-MM|---MBB-B?---E----o-?--------EX---|-----B-oB?-B-----X---|-B--o--|--X|--|-B?------T-M-|-----E-----T----?XT-----T-M--T|X--M-T--X-?--M|--T--E-----?-B---Too--?-T--|-----o-?-|-M---M-
XXXXXXXXXXXXXXXXXXXXXXXXXXXXXXXXXXXXXXXXXXXXXXXXXXXXXXXXXXXXXXXXXXXXXXXXXXXXXXXXXXXXXXXXXXXXXXXXXXXXXXXXXXXXXXXXXXXXXXXXXXXXXXXXXXXXXXXXXXXXXXXXXXXXXXXXXXXXXXXXXXXXXXXXXXXXXXXXXXXXXXXXXXXXXXXXXXXXXXXX
