-------------------------------------------------------------------------------------------------------------------X---o-------------------o--M---------------------------------------------------------
------------------------------B-------------------------------------------------------------------------------------------------------------------------------------------------------------------------
-------------------------------------------------------------------------------------------------------------------------------------------------------M------------------------------------------------
--------------------------------------------------------------?-----------------------------------------------------------------------------------------------------------------------------------------
--------------------------------------------------------------TX----X--------------------------------------------------------------------------------------------------------------------X--------------
--------------------------????--------------------------------|---------------XXXXXXX-------------------------------------------------------------------------------M-------------------XX--------------
-------------M----X-------------------------------------------|----------------------------------------------------------------XXXXXXXX------------------------------------------------XXX--------------
-----------------XX-------------------------------------------|XXXXXXXX------------------------------------XXXX-----------------------------------------------------------------------XXXX----------X--v
--T-------------XXX-------T-----------------------------------|-----------???????------------X---------------------------------------------------------------------------------------XXXXX---------XX--f
--|------------XXXX-------|T-----X--------------------------M-|-X----------------------------XX-------------------------------------------------------------------------------------XXXXXX--------XXX--f
--|-----------XXXXX-------||-----XX---------------------------|-XX--------B------------------XXX-------------------------------------------o---------------------------------------XXXXXXX-------XXXX--f
--|----------XXXXXX----T--||-----XXX--------------------------|-XXX--------------------------XXXX---------------------------------------------------------------------------------XXXXXXXX------XXXXX--f
--|---------XXXXXXX----|T-||-----XXXX-------------------------|-XXXX--------X----------------XXXXX---BBB-------------------------------------------------------------------------XXXXXXXXX-----XXXXXX--f
--|--------XXXXXXXX----||-||-----XXXXX------------------------|-XXXXX-------XX---------------XXXXXX--------------------------------------------BBBBBB---------------------------XXXXXXXXXX----XXXXXXX--f
m-|------XXXXXXXXXX----||-||---E-XXXXXX----E------------------|-XXXXXX------XXX--------------XXXXXXX--E-----------------------------X------E---------E-----------------------E-XXXXXXXXXXXX--XXXXXXXX--X
XX|XXXXXXXXXXXXXXXXXXXX||X||XXXXXXXXXXXXXXXXXXXXXXXXXXXXXXXXXX|XXXXXXXXXXXXXXXXXXXXXXXXXXXXXXXXXXXXXXXXXXXM---XXXXXXXXXXXXXXX------XXX---XXXXXXXXXXXXXXXXX-XXXXXXXXXXXXXXXXX--XXXXXXXXXXXXXXXXXXXXXXXXXX
