----------------B--?---To-------B--|B--?-------------E--------o--|---?-?-----o-------X--------B-----------------------E?-----XT----------------B--X---oM------?--|B|--T----oB-----------------?---?----E
----?-------------------|---Bo-------X------E---|------------X-----o---------------X-ME---M-------T----?----?--------|-------------------B-------X------|----?-----------------M------------------B----T
----B---o-------T-X-------|----o------------E-M------------------------|------T---------X---------------o---X----?------------------------|B----B-o-------B--------|------X-----?---E------E-M---------o
-M--------B-----TE-B----------------------------o----B-------MTo?---------?--E-------E--|--------|----------------------o-----------------M---------------------------o-----B------|----M-------?E-----o
-?--------------X-------X----------------------------------BX------|E---?--------E----------B-----------------------X--------B--Mo---o--?------M-------------M-T-|-----T------E------o-MT|-------------o
--o----BXBM--------o-|--X--X---------?-E-T---------|--|?--------o-M--M|-|---M------?-o------o-------T---oB-T-------------------------------------MT---M-E-?-T--E--oo--------X--------X-----B----E----T-M
--M-----------------M-----------------------oX---|T------M-------------------E--MM--TE---------T-------------------------T-o----o----------|------?E--------------X----M------------------|--------T-M-?
------------------------o----?-------Bo-?---E?------T----X--M----B-E-M----------|---B-oT----B---------------o----------|-----------------M--|----------------X------------M--------B---M--M--------?-|vT
--E--To--|----?-XE?---M--|-X-oX-----B-T----BB----|?|E--------E-B-M--E|B-?-?-X--oT--?-?X-B---T-o----X-B-?--------|-BT-M--MoTTX-E-||-MT--??-B-X--?XM--XEM--oX---T----T-X--B--E--o---XE-M-?-o---E----M-|-fX
-MM----X|-?-----o-?-----T---?E---|-E--o---M--XE|-B-----EEBX-M---?------M---o-M-|-X----------------X--B---Mo-M-------||M-o?-oM-?----T-----B-T?-X-------B-B|BX--------oo----X--M-?--M-----B--M-|--X|-o--fB
-------|-BB|?-|----B---X--E--XM-|o---oXB------|--M?--E-EMX---?X|------T-----|o---?M-B-o--E----oT--o-------X-T|-E-M--E---oX-B?--M-E-E--X-E-o-BE--X-M-oBo---M--?-|----X-|-M-B-X---|X----o-|TM--To---X-E-f?
---o---X------TT|T?o----------X-EE--|-XB---|-----E-?X-E---XEXo---XT--MX-E-T------M--M------T---X--o--B----|-------|E-----EM|---M-||-|?----B-E-M----XX-X----?--------MXo-|--M-M-?--M----XEX---E--T-M--?fM
---ET-|ET--o-o-----T|--TX------B---?----o---o----TX----B--------TM----o--?---------M-X-o---B-----EET-ET-EX------T?--?X-----|-X------B-ToM-?------------M--|T--?BXo-|--E----|-M---X?---E--M-o?-E--?--?-fM
---M--?-o----MTX----|--T----M--Xo-----|T--o-T?E-TXB--B-B--?-oE----o-----To-XX|-o-------BMMB----E---E-T------E----?-o-B-----BBo?---B---|---o??X----X-------E--M-X-?EB-XM---M-EM-|-E----------|?---X--X-fB
m-B-B-|----BTM----o--E-o------|o-M-|---T-----M--X|---X--------B--oX?o|ooB---B?-X---E-|----XM--Eo-|X|-?--o-B------o----?--BM--E--|-----B--|E--|T-----------?-T--|--X----|-T-|o-o-T----o?--E--|--MTT-----M
XXXXXXXXXXXXXXXXXXXXXXXXXXXXXXXXXXXXXXXXXXXXXXXXXXXXXXXXXXXXXXXXXXXXXXXXXXXXXXXXXXXXXXXXXXXXXXXXXXXXXXXXXXXXXXXXXXXXXXXXXXXXXXXXXXXXXXXXXXXXXXXXXXXXXXXXXXXXXXXXXXXXXXXXXXXXXXXXXXXXXXXXXXXXXXXXXXXXXXXX
