--------------------------------------------------------------------------------------------------------------------------------------------------------------------------------------------------------
---------------------------------------------?----------------------------------------------------------------------------------------------------------------------------------------------------------
--------------------------------------------------------------------------------------------------------------------------------------------------------------------------------------------------------
--------------------------------------------------------------------------------------------------------------------------------------------------------------------------------------------------------
-------------------------------------------------------------------------------------------M------------------------------------------------------------------------------------------------------------
-----------------------------------------------------------------------------------------------------------------------------------------------------M--------------------------------------------------
--------------------------------T----------------------------------------BBB-----------------------------------T---------------------------------------------------?------------------------------------
--------------------------------|-----------------------------------------------------------------------------X|XX-------------------------------------------------------------------------------------v
--------------------------------|------------------------------------------------------------------------------|---------------------------------------------------------------------------------------f
--------------------------------|------------------------------------------------------------------------------|--------------------------------------------X------------------------------------------f
--------------------------------|-----------------------------T------------------------------------------------|-------------------------------------------XX------------------------------------------f
--------------------------------|-----------------------------|------------------------------------------T-----|-o----------------------------------------XXXX-----------------------------------------f
--------------------------------|-----------------------------|------------------------------------------|-----|-----------------------------------------XXXXX-----------------------------------------f
------------X--BBBBB-----------X|-----------------------------|-------------------T----------------------|-----|----------------------------------------XXXXXX-----------------------------------------f
m----------XX-------------------|-----------------------------|-------------------|----------------------|-----|---------------------------------------XXXXXXX-----------------------------------------X
XXXXXXXXXXXXXXXXXXXXXXXXXXXXXXXX|XXXXXXXXXXXXXXXXXXXXXXXXXXXXX|XXXXXXXXXXXXXXXXXXX|XXXXXXXXXXXXXXXXXXXXXX|XXXXX|XXXXXXXXXXXXX--------XXXXXXXXXXXXXXXXXXXXXXXXXXXXXXXXXXXXXXXXXXXXXXXXXXXXXXXXXXXXXXXXXXX
