---------------------X-------------------------------?----o---M-?????-----------------------------------------------------------------------------------------------------------------------------------
------o---------------o-----------------------------------------------------------------------------------------------------???????------------------------------------------------------------B--------
-----------------------------------------------------------------------------------------X-------------------------------------------------------------------------------------------o------------------
----------------------------------------------------------?----o--------------------XXX---------T----------------------------------------------X------------------------------------T-------------------
------------------------------------------------------------------------------------------------|-----------------------------------------------------------------------------o-----|BBBBBBB------------
----------------------------------------------------o-----------???????-------X----T------------|-------------T--??????------T------------------------------------------------------|-------------------
-----------X-X-------------------------X-------------------------------------------|------------|-------------|--------------|--------------------------?---------------------------|-------------------
-----------XXXX--------X-----------B--XX-------------------------------------------|------------|--------X----|--------------|-o-----------------------------????????---------------|------------------v
-----------XXXXX-------XX--X---------XXX-------------------------------------------|------------|-------------|--------------|------------------------------------------------------|------------------f
------T----XXXXXX------XXXXX--------XXXX-------------------------------------------|------------|-------------|--------------|------------o-----------------------------------------|-------X----------f
------|----XXXXXXX-----XXXXX----?--XTXXX---------M---------T-----B--X---------T----|------------|-------------|--------------|------------------------------------------X-----------|--X---------------f
-?????|----XXXXXXXX----XXXXX-----TXX|XXX-------------------|--------XX-o------|----|------------|-------------|-?------------|-----------------------------------------XX-----------|--XX--------------f
------|----XXXXXXXXX---XXXXXX----|XX|XXX-----------------X-|--------XXX-------|----|------------|-------B-----|--------------|----------------------------------------XXX-----------|--XXX-------------f
-B----|----XXXXXXXXXX-XXXXXXXX--X|XX|XXX----------------XX-|--------XXXX------|----|------------|-------------|--------------|---------------------------------------XXXX-----------|--XXXX------------f
m-----|----XXXXXXXXXXXXXXXXXXXXXX|XX|XXX-E-------------XXX-|E-------XXXXX-----|----|X-----------|E--------B---|--------------|-------------------E------------------XXXXX--------E--|XXXXXXX-----------X
XXXX--|XXXXXXXXXXXXXXXXXXXXXXXXXX|XX|XXXXXXBXXXX-XXXXXXXXXX|XXXXXXXXXXXXXX-?XX|XXXX|X----XXXXX--|----XXXXXXXXX|XXXXX-XXXXXXXX|XXXXXXXXXXXX----------XXXXXXXXXXXXXXXXXXXXXBBBBXXX----|--XXXXXXXXXXXXXXXXX
