---|o-X--------------oB---------------------------------------------------------------------?-o-----------------o--X----------------E---------------T---oo-----?-?--T-------?---X-T-|X--M---o---T-E----E
------------B------------B----o------------------------E-B-----M-----------------M-E--o---------M-TE---------M--E-----------oX-------------------X--o--------B--?--|--M-BE--T--B--M----B------------M--|
--------?----|----------E----------X-----T?-----X----------X-----?-----------------------|---o--o------|-------T---------|----------X-------------o--M--?-|-----------X--------------------------------?
-----M---------------X--M----------------M-----------------X|-M---------o--E----------oE?---------o-----------B--?-----T----E-------------------?-------------X--M----------------------------------|--E
-------E------?-|------B-|-----?------------X----------------?--T--o-----X--------------?-------|-------------T------------------X-----E---------------B-X---TT---o-E--|----------|-------------T----E-B
-B--------B-B--------------To--B------B-----T---------------?---------------------|--|-T-----------T-|-------E----EM---?----X---o-----------------X------------------------B---------------M----M---M--o
-------BToE|---|---T--o-----B-|----|--------X-?-------E----Bo----E-------------B-----T------------E----------------------B--o--------------MT|---B---o-T---o--------------------B--M---------T|--------?
----M--------------?----o----------------------------------------M---?X---------M----------M------T-|---------?------?--------------E--?------X----------B--------------------X------|--------|----X--vT
-B-BBo-M|-TE-o----B|--|----TXEE-XTE--o|---|B-T?M|---------M-E-----??--E---E-Eo--T-?|---B---BX----E---E---o--o--T-T|-------M--E|T---oo---o-X-----B--------o-XX----?T-E-|-||-?-----o|--MM|----MXT----M--fo
------X-E-MX-T-XE--TM---B-?o----XE---X-B-----M----TT--X---To--B-X----MX-|B-T-X--|---MM-------|?--M?|-MX-||--o---E---?----B---------------M--E---T|-BB-----T---XoT-----E-X----|--o-??EE---E?--E-T------fM
--?--------XB-M-----M-o-T?--o|--?o------o-o-|T?o--B------oBX------|T------E-M---|-T?ET-|--------------B--T|-M-B-T---B--T?|TXB-E------?--E|-MTT?-T--?----X-|-------XX--?B--------|----M-|------o-BMT-B-f?
-TM--?---TT--M|---EX-|--?|?X?X---E--T|--oM-|---T-TX---o?-|----B-TB------E-----------XM----B-|--?--M-E?--B--Boo|--------M-T--|T--B?--X-|-M----------E--?---|-?---M----M|-|-X-----oXME-Xo---E-T---X-X-?-f?
-BEEE---o-Bo--T-------X-oM---------o-------o--oM---X----M-T|------E-M--o|--M---|TE----T|o---?--E-B--B-T----o|-X--|o--?------|o-?---E-B----?-o|-o---o|-?TE||oT|E------M--o----M--B-XE|-E?--B-E-o-oB----fo
--T-----EM-M--BB---M----E?X---B-o--?--B---TT---E--?--X-BT----XMX?-BB----|-------BoX--TM-------------------|----?-M----E-T--E-T---M---X----EEo----ME--?----B---?|--T------T-oX?---E--T---|-XB--Xo---BM-fE
m----o-B---M------E---M-X-----?--X--M-Bo-X---X-?-M----E-?T-X-X--------oX-T--E-|?---|-|--|----E-T-E--BB-TT-----E-oX----?-------BM--Bo-o-----------|B-|EE-EX---?X---T----E--T-B--o-----XT--M-E----E??-----
XXXXXXXXXXXXXXXXXXXXXXXXXXXXXXXXXXXXXXXXXXXXXXXXXXXXXXXXXXXXXXXXXXXXXXXXXXXXXXXXXXXXXXXXXXXXXXXXXXXXXXXXXXXXXXXXXXXXXXXXXXXXXXXXXXXXXXXXXXXXXXXXXXXXXXXXXXXXXXXXXXXXXXXXXXXXXXXXXXXXXXXXXXXXXXXXXXXXXXXX
