----T----M-------o------------------------|-----|------E---------------TE--------X--------------------------?---B-X-E-------?----|-----------o?----------?----T--?--------------------------------------
--E---?---B-----------M-|---E-----------------------------M----M---X-To------------|------------------------M-----------B-?-----MT--|M--------------------TMT------?M-------------------X------X--------
-o-?--M-E-------?---------B-B?---------T---M---M-------------?--------|--M------------?-------T-------TM------X-----------------?-To--E---T---------?-----------E---X--------?-----------M-----E-------T
-----|--------------T-M----|----E-----------M---|-----EB----E--------------------?oT----BB?-T-M---o----------X------o---------B------------X----E-------M---------?-o-----------------E----M-----------?
----?-------------------------|-----------------------------|---------------X-MM-------T----E---------------o---o-------?-o---X----?--M--------------------B--M--------|-----|o---TM--E---?---T--------T
-------B-----------E----------------------------B---------|-------E----------------T-------T---------------------------------M--B----------------T-X----o-------B---|---------------------o------------B
--T---|-------|------------------------------------?-----------------------|------------|T-------------------------------------?--------------oE--------------------------------o-------------o---B-M--E
-T----?---B----|----M----------------------E------------------------------------X--------B--------------T---E-------?-------E---------------------------o-----M--o----X--------------E---|----M-------v?
----X-X--o---------|---?-B---E-Eo?o-E--?T-------------X--B---o--?-M-XM---X--?----E-TM--T-B--?E--X------?-M----B-E-?---o-E-TM---|---|------T---B-o--BoB------B-|----T|--M------o----X----T--T-----?XT--fX
------Bo--B--?B--o-----?--E--?----E-E----E------------?--ET-o---|---|----BXM-oBX|--X?--M-M-oT---BM|-T-X-E------?E---|B-|---E---M-o-E-------B?XTMMM-|Xo-E--E--X-o----T-TMX---T-M-|B--BTB-X---EEX--BX---fT
--M---X---?-ME--|-?o-------M|----E-----XX-oM------M--M----?|-B--MM----------X--oE------?--E----MM--|--?EEE---o-M?o|M-E-?----B?o-B--MB|-|------X-|--------B--E?E---TE--?--X|-?--?-X-B|---?BoT||-E-B-|--fM
-?o----X--X-----E---|--TB-----|-T----?-----X---MMB--BE-o----T-?----o-------Xo-|?|-TM-------?-?-E--XB-T--?-------?-o---------|---ME-----|?-X---E-|-E-------|-|X---B----M?--M-------B|T----|B|--o---T---fX
----B-------?----?--o-------E---E-----?M--?----o----o--------M--T----E----EB----|--BXT?--|-|--o?-|--ET|-EB-?---?---oo--|--M|Xoo-----|E------E?||--|-----X---E------X---BoE----BT-M--B----o-|--------oTfX
---X-oT--Xo??-T-EE-?------M-----?M|E------X--XM--o-|??-?-M--T|-M--?-?ET--o--E---B---?-------B--o-|-B---M-|?---E-E|-?-X--T-BM---------E|-?-?M-B---X--X-|o----M-MT---?-TB--ET---|-T--?-?----BB-|B-EMXB--fM
m-?-ME------o-BTB--T-------X-XB----E--E---X---M-|--XTM-M------B--|--T-ME-------|-B-|-B--------E-TE?--------BM-|-X-----MB-|-T---?---|----T----o---X-----|--MT----??E-EM--XT-B------M-------X-?-E-E-?-?--o
XXXXXXXXXXXXXXXXXXXXXXXXXXXXXXXXXXXXXXXXXXXXXXXXXXXXXXXXXXXXXXXXXXXXXXXXXXXXXXXXXXXXXXXXXXXXXXXXXXXXXXXXXXXXXXXXXXXXXXXXXXXXXXXXXXXXXXXXXXXXXXXXXXXXXXXXXXXXXXXXXXXXXXXXXXXXXXXXXXXXXXXXXXXXXXXXXXXXXXXX
