---------X-----------B-----------------------M----------------o------?---------------|-----------o-T----B---M---------------|---------------T------X--------|-------------------------------?---|------o
------------------------M--|--------------------|o-----------M-o------?---------------B----?---?o-o------o--------------|T-------o------------X----?---|---------E----------------------?---|--------T-T
---o---M-----X--|---o--B---B---X--T----B-----------?---------T--E---M--Mo--M-------?--------------------------------E------------------E-----B----------?---?---E--X-----B-----T--o--E------oB---------E
--?----------------o---------------T-------------M-M-XX|TE---E-----------T?---------------E-----M------------?----?-----------------------M--o---X-------------o-------BX-?---o?-B---o-----------------T
-----X-X-----------------------B--E-----------T----?---oE---?-|---X----------M-------?---------------ooX--------------o----------------T-----------E----------T---------B----------o---------------X---o
-T|------------------T--------------|-B----X--B-------E-E-|----------XE--------M---------E--o--X--------E--------------T-X-----------------------X----------------------oMBE------B---E----------------?
---------B--B---B-------------E----|-----------E----B-X--T--o-----------------------E-|------------------------X-----T-------------------T-----------X-------o-B--Bo------------|-----------EE---|?----o
-o------M-----o----o-----------M---------------M---------B-BE------------BTB---------?-------X------------o-|--------------------?|------E-----B----------?------------------------?-------X----------vX
---T---E--M--|------|BB--o-M--B---X--|--T-?o--o-T-M---T-M-------?E----M----oT--?---EoB-B-E-T------------X-X-E-T----M-X-|--ET||------oo-M|--B-X--X--M---------------?--|-X---o---B-------B--B-?o-o--|--fE
-?-E--o-MMTTE-T-?T-M--MT----?--E?TX-------E----|--------M-?----BX------o??--T---T-|B---|T-----------o--|o----E-M|----|-|-|--o-BBT--E-o-X---T----BE--?X---?-----oo?------T?--|-X-ToX---|BT-?-|---XE-oo-fM
--|M-B---B-E----M-BXT------ToT-B?B--T--Eo------M--E--M|-Eo||--B-----TMM-XT------B-T-o--E?----B-TE--|To-E-Mo-----------o-X|--X--?-T-?--X-?BEX-o|M-|---X??-?--B-oX-ET-T---M-------E---E--T--BB---M-EE---f-
--o--EM----?----|--?--------o----|--T------?--|-MB---o-o-B----------o-E----E---?---o-|----o-B---o----------E--BX-?-MB--M-B-T-X-----TB?T-?-T-?|-----E-BB-------X-----T---X-X-----o---oM-E----o-E---|---fB
-|-T--?-X-MM-ET|o-?-|--?-|-||------?---EBT--X---To---E?----E-M-o|-oT--?MT-o-B|?--oo----E-B-|?-?X|?------T--M-|E-E--|MT---T?-E---|E-M------TTo?--M?-X--?-o--E-|------|M-|-|--M-------------XB---B--M---fT
-|-oEo?------o---T?-E-?----o--T---|-M-------B-X-o-??E-oE-|-|?-------o--BXT---X------E--T-B----EX?-E||-MB-T-oB-M--?oT-B?Eo----o--M--X-EX-|?-M|ET-?-------MoX---o-----T-E--M-M-BE----T-E-M?|o--X|-?|-B--fB
m----o--B----M-oTT--|--------?-?----B---|---M--B----EoT-BB----Xo|--XoE-X-|----B-o-?-EM?----?--T--?-o---T---B--o--oB-T-E-|--MXoX--B?B---E---T|MX----E?BX?E-|-X---E---BB-MM-XB---?--X?-|-----MM--M?-----T?
XXXXXXXXXXXXXXXXXXXXXXXXXXXXXXXXXXXXXXXXXXXXXXXXXXXXXXXXXXXXXXXXXXXXXXXXXXXXXXXXXXXXXXXXXXXXXXXXXXXXXXXXXXXXXXXXXXXXXXXXXXXXXXXXXXXXXXXXXXXXXXXXXXXXXXXXXXXXXXXXXXXXXXXXXXXXXXXXXXXXXXXXXXXXXXXXXXXXXXXX
