-X-----------------------------------------------------------------------??------------------------B-----------------------------X----------------------------------------------????B-M-----------------
--------------------------------------------------------------------------------------------------------------------------------------------------------------------------------------------------------
-----------------------------------------------------------------B----------------?--X--------------------------------------------------------------------------------XXX-------------------------------
----------------------T--------------------------------X------------------------?-----o--------------------------------------o------------------------M------------------------------------BB-----------
----------------------|----------------?----------------------------------------------o---------------------------o-----------T--------------T-----------------------------------------------XXXXXXX----
----------------------|---------------------------------------------------------------------------B------------X--------------|--------------|------T----------------------------X----------------------
-----X----------------|--X----o--------------TT--------------------------------------------X------------------XX------X-------|--------B----o|------|-----------------------------------------------X---
----------------------|----------------------||-------------------------------------------XX-----------------XXX-----XX-------|--oX----------|------|--------------------------------------------------v
--------------T-------|----o-----------------||----------------------???????-------------XXX----T--T--------XXXX----XXX-------|--XX---BX--X--|------|---------BT---------------------------------------f
---T----------|-------|----------------------||-----------------------------------------XXXX----|--|-------XXXXX---XXXX-------|?XXX----XX-XX-|------|--M-X-----|----------------------BBB--------------f
---|--------B-|-------|----BBBBBB----------o-||-------------T---------------------T----XXXXX----|--|---M--XXXXXX--XXXXX-------|XXXX----XXXXXX|----T-|----XX---T|--------B--------------X---------------f
---|----------|-------|----------------------||-------------|---------------------|---XXXXXX----|--|----XXXXXXXXXXXXXXX-------|XXXX----XXXXXX|----|-|----XXX--||-----------------------XX-------------of
---|----------|-------|----o----------BB-----||X-----T------|---------------------|--XXXXXXX----|--|----XTXXXXXXXXXXXXX------X|XXXX----XXXXXX|X---|-|--B-XXXX-||---------------------X-XXX-------------f
---|----------|-------|?---------------------||XX----|------|-------------------BB|BXTXXXXXX----|--|---XX|XXXXXXXXXXXXX--o--XX|XXXX----XXXXXX|XXo-|-|----XXXXX||--------------------XX-XXXX------X-----f
m--|----------|E---EEE|-----E----------E-E---||XXX---|------|EX---------E---------|XX|XXXXXXE---|--|E-XXX|XXXXXXXXXXXXXX---XXX|XXXX----XXXXXX|XXX-|-|E---XXXXX||----E------?-------XXX-XXXXX----XX-----X
XXX|X--------X|XXXXXXX|--XXX--------XXXMXXXXX||XXXXXX|---XXX|XXXXXXXXXXXX-XXXXXXXX|XX|XXXXXXXXXX|--|XXXXX|XXXXXXXXXXXXXXXXXXXX|XXXX----XXXXXX|XXXX|X|XXXXXXXXX||XX-------XXXXXXXXXXXXXXXXXXXXXXXXXX----X
