-------------E-----M---------------------M-------T-T?-----------X-------------T-------E-T---?-B---------E-X------------------X---B-------------------E--B-o---T-------------------X--o-------o-----E----
-|T----------M--E--------------------------------?----------E-|T---T?-----EE-----|---T---|-------------?--E------X---------B---To----M-------EX---------E?o-----E-----o--|-M-------M---E-X-----------?-o
----M----------E-MXT-??-----T-X---B-X----|o----B------------B-|---------------|---------oX------o-T?----------------?------o-----T--------M------B--o-----E-------?-------------------X--------E-------X
--------X-E--B-------E-o-------B---------B----------------------E--X-X------------M--------|---M--Eo----------?--?---------B------------?--------TX-T-------------B--------------o--T------?M-|--------T
-----?-------T----T-----------o--------|--------|-------o--------B---T---------------------MT---?M--------E--B-------------------------------BM?----E----TM------------o------------M--------T---------X
-----o-------------X-------E--------------B--------Xo----?--------X|--M----B?-----X----------E-----T-------TM-------X-------o-----o-----?-------E-EX----------o--?-----|---o------------------------?---
-E-----------------E-M------------T-----E---|---?---T------?---------T-------X----------?------|----E----?--------------|----------?--------------B-X-o-------------X-M---------X------X-------?-------B
---|-----B--------M------o-T------|--o------X----M--E----------|-?-----o-?----------------T------------B----------XX|------T-----Xo----X-----TM-------------------T----T---o---------B----------M-----v?
-----EM--?-X----------|---B-|--M-MT-|--T--|--------o----o--B-X--E---B----TE-|M--|--?o-B--TT--------XoB--oE---B-MME-|-BM-------E--X------E--M--|-E?o-X----T-o-M-?---X-B---T----------M?-o---E-TX---M-X-f-
-----B--M----XoEB----T----|--XX-ET---|-TT-----B-M------BB-o-------T-T----------?X------------B-----X-B--M---o---------oT-|--MX---B|-B---E--X----EM--B--ME-|----E-E-|-?X----E|-----------X---|-|---|---fT
-T--XB?--?-----B-X-X--|-?--|E----MM-|-BX|--|M--BE---B----MBE---|To-E------|o-----?---?---X--B|E--|---X--B---B-B??--M-o-----B-?|---|TX-----------E|-?-|-o------?EX--MTMX-----|---|-----MM-??-M-?----EB-f?
-M------|-TM-|----B--X-------M----T|oM--|T---X-B---EX----o-oB----|--|-EX-|M|-B-B-T--T-?---?XE-|-|-X-o-M---E?MTB-??----?-|-E--|-M-o--?EoE---oTX---TX-MMB-|-X--oE------|E---E?-B--B-------|-X?--M----XETf-
-o--M-M--MM|-TMB---|--o--T|-M|-X-|-B-??-o---o--BE------o-B-----|---T--BM--o----BB---|---MT----------------X-EoooEX-E-B----T--o?oE|-|--X---?|M-M-E---?---E---XB-T-M--?-?-X-----E-----|---T-B--?-X---B-ofX
------ETT----TE--E---|B-------X----TX--?------??X-E-T-X------X-?-|B|-B-??-M---E----E------|---------M---XX-BBB--BoX---Xo-E--BTE-M------E-Mo-|--?-BXX--E-----|--o---T--EX-|B|X--B--X---X----o--E-------fB
m----|--|--T--------B--E--o----oB-B------------------o-----M-oT-----T-o---oX------------?E-MM----|--------?---oE---E--M----M-EX-----|--MBE---------X--XM---?|EX-E----MTT---M-?--X-BB-XT--M-----oM-----BT
XXXXXXXXXXXXXXXXXXXXXXXXXXXXXXXXXXXXXXXXXXXXXXXXXXXXXXXXXXXXXXXXXXXXXXXXXXXXXXXXXXXXXXXXXXXXXXXXXXXXXXXXXXXXXXXXXXXXXXXXXXXXXXXXXXXXXXXXXXXXXXXXXXXXXXXXXXXXXXXXXXXXXXXXXXXXXXXXXXXXXXXXXXXXXXXXXXXXXXXX
