---------------------------------------B-----------------------------------------------------------------------------------------------------------BB---------------------------------------------------
-------?------------------------------X----------------------------------------------------------------------M------------------------------------------------------------------------------------------
--B-----------------------------------------------------------------------------------------------------------------------------------------------------------------------------------------------------
-----------------------------------------o---------------------------------------------------X---------------T---------------BBBBBB---------------------------------------------------------------------
-----------------------------------------------M--------B----------------------------------------------------|-----------X-o--------T-------------------------------------------------------------------
------------o-----------------------------------------------?X??????-------o---------------------------X-----|----X-----------------|-------------------------------------------------------------------
------------B----------------T----------------------------X-XX-----------------------------------------XX----|----------------------|-------------------------------------------------------------------
------------------X----------|----------------X------------XXX-?-------------------------------------?TXXX---|--M-------------------|------------------------------------------------------------------v
-----------------------------|----------------------------XXXX----------------------------------------|XXXX--|----------------------|------------------------------------------------------B---T-------f
-----------------------------|---------------------------XXXXX--X-------------------------------------|XXXXX-|---X------------------|----------------------------------------------------------|-------f
-----------------------------|--------------------------XXXXXX----------------------------------------|XXXXXX|--XX------------------|-----------------------------------T----------------------|-------f
-----------------T-----------|-------------------------XXXXXXX----------------------------------------|XXXXXX|-XXXX-----------------|--------M--------------------------|----------------------|-------f
-----------------|-----------|-----------------------XXXXXXXXX-----------------------------------T----|XXXXXX|XXXX------------------|-----------------------------------|-----------------X----|-------f
-----------------|-----------|-----------------------XXXXXXXXX-----------------------------------|----|XXXXXX|XXXX------------------|X---?---------------------------T--|-------------X--XX----|-------f
m-------------E--|E----------|----------------------XXXXXXXXXX----E--------E---------------------|E---|XXXXXX|XXXX------------------|--------------------------------|--|-------E-----XXXXX----|-M----EX
XXXXXXXXXXXXXXXXM|XXXXXXXXXXX|XXXXXXXXXXXXXXXX-----XXXXXXXXXXXXXXXXXXXXXXXXXXXXXX--------XXXXXXXX|XXXX|XXXXXX|XXXXXXXXX---XXXX------|XXXXXXXXX-XXXXXXXXXXXXXXXXXXXXXX|XX|XXXXXXXXXXX--XXXXXXXXX|XXX---XX
