---------------------------------------------------------o-------------------------------------------------------------BBBBBBBB-------------------------------------------------------------------------
------------------------o-------------------------------------------------------------------------------------------------------???????-----------------------------------------------------------------
-------------------------------o-------------------------------------------------------------X----------------------------------------------------------------------------------------------------------
--------??-------------------T--------------------B--T--------------------------------------------------------------------M-----------------------------------------------------------------------------
-----------------------------|-----------------------|--------------------------------------------------------------------------------------------o-----------------------------------------------------
---------------------X-------|-----------------------|---------------------------------------------------X----------------------------------X-----------------------------------------------------------
-????-----------T----XX------|--MBBBB----------------|------???------------------------------------------XX--------------------------------XX-----------------------------------------------------------
----------------|---MXXX-----|-----------------------|--------------------------------XX-----------------XXX-X----------------------------XXX----------------------------------------------------------v
----------------|----XXXX----|-----M-----------------|---------------------------------------------------XXXXXX--------------------------XXXX-----------------BB---------------------------------------f
----------------|----XXXXX---|-----------------------|-----------------------?---------------------------XXXXXXX-------------X----------XXXXX------------X---------------------------------------------f
----------------|----XXXXXX--|-----------------------|---------------------------------------------------XXXXXXXX-----------XX---------XXXXXX------------XX--------------------------------------------f
----------------|----XXXXXXX-|-----------------------|------------T------------------------X-------------XXXXXXXXX---------XXX--------XXXXXXX------------XXX------------------------------------------of
-----------T----|----XXXXXXXX|-----------------------|------------|--------------X---------XX------------XXXXXXXXXXBBBB--TXXXX-------XXXXXXXX------------XXXX------------------------------------------f
-----------|----|----XXXXXXXX|-B-----?---------------|-----------?|???-----------XX--------XXX-----------XXXXXXXXXXX-----|XXXX------XXXXXXXXX------------XXXXX-----------------------------------------f
m-------E--|----|--?-XXXXXXXX|X----------------o--EE-|------------|--------------XXX------EXXXX----------XXXXXXXXXXXX---X|XXXX-----XXXXXXXXXX------------XXXXXX----------------------------------------X
XXXXXXXXXX-|-XX-|----XXXXXXXX|XXX--XXXXXXXXXXXXX-XXXX|XXXXXXXXXXXX|XXXXXXXXXXXXXXXXXXXXXXXXXXXXXXXXXXXXXXXXXXXXXXXXXXXXXX|XXXXXXXXXXXXXXXXXXXXXXXXXXXXXXXXXXXXXXXXXXXXXXXXXXXXXXXXXXXXXXXXXXXXXXXXXXXXXX
