--------------------------------------------------------------------------------------X-----------------------------------------------------------------------------------------------------------------
--------o---------------------------------------------------------------------------------B----------------------------------------------?--------------------------------------------------------------
----------------------????------------------------------------------------------------------------------------------------------------------------------------------------------------------------------
------------------------B------------------------------------------------------------------------o---------------------------------------------------------------T--------------------------------------
-------------------------------------------------------------BM--------------?---------------------X-----------T--o-------------------------------------T-T------|--------------------------------------
---------------------------------------------------------------------------------------------------------------|----------------------------------------|-|------|--------------------------------------
--------------?--------------------B---------------------------------------------------------------------------|---------------------T------------------|-|------|--------------------------------------
-----------------------------------------------------------B---------------------------------------------------|----------------XXXXX|X-----------------|-|------|-----------T-------------------------v
-----------------XXXXXX----------------------------------------------------------------------------------------|---------------------|------------------|-|------|-----------|-------------------------f
---------------X-----------------------------T---------------------TXX-----------------------------------------|-------X-------------|------------------|-|------|-----BBBB--|-------------------------f
--------------XX----------T------------------|---o-----------------|--------------------------------XXXXXX-----|------XX--B----------|-----------------B|-|------|-----------|-------------------M-----f
-------------XXX-X--------|--????????--------|---------------------|-------------------------------------------|-----XXX-------------|------------------|-|------|-----------|------T------------------f
---B--------XXXX-TX-------|------------------|---------------------|------X------------------------------------|----XXXX-------------|------------------|-|------|M----------|------|------------------f
---?-------XXXXX-|XX------|------------------|---------------------|------XX-----------------------------------|---XXXXX-------------|------------------|-|------|-----------|------|-------------BBBBBf
m---------XXXXXX-|XXX-----|----E-------E-----|---------------------|-----EXXXE---------------------------------|--XXXXXX-o-----------|ME---------E---o--|-|------|-----------|------|------------------X
XXXXXXXX-XXXXXXX-|XXXXXXXX|XXXXXXXXXXXXXXXX--|----XXXXXXXXXXXXXXXX-|XXXXXXXXXXXXXXXXXXXXXXXXXXXXXXX-XXXoXXXX---|XXXXXXXXXXXXXXXXXXXXX|XXXXXXXXXXXXXXXXXX|X|XXXXMX|XXXXXXXXXXX|XXo---|--XXXXX-----o-----X
