--------------o-T---------------------X------X-M-------|--------------E--------T----------EM----o--------?-M-------------|--B?-------E-B----?X--------B-------E--B---------M--E--------M----E----------B
--T--------------------|X---X---------------------X----------E------------------M--B-------------o----------------------?----------------B------------M---M--?---------?--------------E---M------To-----
--T------------------B------------E---M----------X---o-T--M------------|----------?--X----M-----M-----------X------o--E---------o---------ME-----------------------------B------------------------o--|-M
-----------------|---B----------o-B------?--------B-M--B--------|-TT------------------E------------------------M-------------------|--------------E--?----M------------------------o------To-X-|-----|-B
----T---T--M--------T----------|------T------|----??--------?-----------X-T----||--------------E------|--------------|--------M--------BM-----------------o-------T--------?T----------M-------?-----T--
-------M----------------B-----M------------M-------------------T---------E----T------------------------o--------|--EMM-----oXE-----------ET---------E---B-----|--|------E-----B---------|---X-------X?-M
-----E---------------------T---------E--?-E-|-|--------------T------M---?-------T--M----------oX--M----------B--------------o|------------?-----------------------|------?---B-----------------------E-E
-------oo---|---------o-----------------|---------E-------?|------------|-|--------MT----X------|----T-|----MTE----|------B----XE---------?-?B-E-X---|---------B------------|-----B-------------------vB
------M-XT--X?-T|-?------Eo-B-------T---M-TE------------oo---o-----|-||-----E?--------o-|-T--E|--M-oM-----o|o--M|---?--EB-TM|EM---TE----M----X?--E-|------o--?B---X-M--|---B|----o---X-EX------?---oo-fX
----oBM?B--B--TX-?------o-M-------|-------M-o?---B?M||-oX--Eo-E?B-?-o--E?----oo?----T--?-?-E?|---BTo-|-|?-B-B?---EE--E-|-------?-Eo-MM|T?E---M--M-B---XEBTM-?----?--o||M---X-E---o------oo-T-X-|Bo--X-fo
--XM-----M--E|----BX----X-oMM----?EM--o--------?E-X--E----Mo-|----oE----------|---XM-B?--B--X--||TE-XM--|--oo-|------o|?---|-?-?-----------o--------M-E-X-----X-----X--|---------o|-----o--B|----o-?--f?
---X---o?--|Xo---B-----BToo-TX----X--?-X---B-E?-----B|-E---E---E---|----MX-----?M-ooM---oEE-------T--T?-X---B--?----oET-X-E--X---------?BB--?M-?----?--M?----E-o-MMo--M-E--B-----M-?----M-T---------E-f?
---M----------|E?-------|ME|-X-o?o|XE--B-BM-----||-?TME----M?-?-Bo-----B------MB---TME------|-----TE--------?---?X-o---|--o-T-XTEM|-B|?-----E---E---o-|--------|XB--||-X----E---o-BB?-M---oM------|---fM
-----X-|----B-Bo--?EE--|-|-?--B-M-----?-----?--|--|?-----E?|---oo-T?|----oE--M---B--Bo?--|-------X----X-E-ME---?---M-T?BMoE-B?|o----B---E--------B--------?----------BB-|B----?Eo--o-?-E-o----------o-f-
mB-E-?E-------XoE-----|--------B-|M----BXTX-----?----TTE--Eo-|------X----M-X-?T--EM---M--------B?---E--B-E|--B-----XBETB--|X-----?EM-o?--|--B-|-E--B--M?-M-?E---------E-M-M--Mo-----o-MM-----------?-TMM
XXXXXXXXXXXXXXXXXXXXXXXXXXXXXXXXXXXXXXXXXXXXXXXXXXXXXXXXXXXXXXXXXXXXXXXXXXXXXXXXXXXXXXXXXXXXXXXXXXXXXXXXXXXXXXXXXXXXXXXXXXXXXXXXXXXXXXXXXXXXXXXXXXXXXXXXXXXXXXXXXXXXXXXXXXXXXXXXXXXXXXXXXXXXXXXXXXXXXXXX
