---------o-------T---------B----Bo---------------------------------M-----|-------?---------------M-T------------X------------------?-XX----M--------------------------------------?E?--o---------------|
------M-o----B----E--------B-------------|--X-------------E-------------------E-?-------------------X---------------------?----X-------------------o------------|o-----------?---------------E-o-E-T-o-?
-X--?------------E-M--E--?-----------------E-o----o------------T-?-----E-------T---T--------|--M---?-------?----?B--o---o-E----------|-----X----o------M--o--------X-------?---X-|----------B----------B
--------B---MB-------------X|-----?-|-----------------------------?-----?----B-------X--o--?----|--X-----E-------M---------------?---------------------B-------------------------------E---------B------
----?----------T---------------?----?M---------------B----M-------------------|------------------X------------o-------E-E---B-M---E-----M--------|--------------------T---X---------o---E--To-------X--?
-|----------E-------B---|X|-M----o-BE|X---|-----------------------------|---------o--------M-|----E------------?--|-o-B|B-o----M-?-------o------------------B-----------M-E-------o---------|----------|
------------?----T------------o-T-B------------T-----------------BX?---------E----M---B------M--E--------------?----------------X----M---------------E-------o--------|??---o--------------E-----------E
-X?--------------?-------|X------B-----TM------------------------------------------------------------M-B---M-----B-----------------------X--|T---?------B------XX---?------------M------X-TX------|---v|
---EBXM---o--T-?--------B-?--o-----------?-----X-T--B---T---B---XB-----?M?ME--EEX-o?--B---?-oE-BM-M--B--|M------------o-----?---TX-|---X-|---E-M-TB-TE-------T|E?-X----M-B--BX-B------------|-X--T-B-MfE
---|-B-o----EMT-E-?----?-----X--B-o--XE--------|-----TX-?|E|-------------T--X---------Mo--B--------EBoM---T-T----Mo-T---?--B---------?----M---M---M?M--X---------------ET-M?E-X--XoB--------XT|E---oBTfo
-----E|o-|---|--E----X-----EM-E-?---M------T------M-X-M--?-T|------B---T--------------o|-T----?M-|-M--EM-o-E--Eo--X-E----|-?--ME---XM---E??o-MB----|--------o-----?--------------------M-B---T-T-B---Tf-
---------?----?-MMoB-M---MM-M-TX----T-X---o--BE|MB-----X-------T---T--o-------------EXTB-|TToX--M-?BMX-XM-o--o|----B-EoE|-----o--M|XB------B?--------|X--o--?-|-MME---B--EM--B---X-|B----X--BE---|-BoBfT
-B-XE----B--BB----T--M-|-T----EE--X-T---?-M?-Eo-?-|E-|-X-|B----E?T--XXT?E--------?X----?----Mo---T---o|?---E--?---EX--------TM|-B---X---o--|------B----?-B-T--M--M?-MXB---|---o--M----E-?B|-TM---o--E-f-
-----M---------o|T--T---E------T--T-----M-E----X----oM--o-----B-T--o--o-X-BT-X--oX--X?--o---BXX--X-MM----?MB---oM-oo-------X-oo---X|--T?o|XB--o---?-|-MXE----E-------X---BB|-E-MM-M-X-?-X--?X|X----M--f-
m-------B-BB--X---|---o?--T-|-X|-------oE-EM-E-----E-----------|-ETX----MB---?--o--|?T----M--B?-B--o----X-?--BX-?---BM?---B--o--?--E--------T-o--M-BM-Xo--B-X-M---?--o---M---B|M-B-M---------|--||T----|
XXXXXXXXXXXXXXXXXXXXXXXXXXXXXXXXXXXXXXXXXXXXXXXXXXXXXXXXXXXXXXXXXXXXXXXXXXXXXXXXXXXXXXXXXXXXXXXXXXXXXXXXXXXXXXXXXXXXXXXXXXXXXXXXXXXXXXXXXXXXXXXXXXXXXXXXXXXXXXXXXXXXXXXXXXXXXXXXXXXXXXXXXXXXXXXXXXXXXXXX
