--------------------------------------------------------------------------------------------------------------------------------------------------------------------------------------------------------
--------------------------------------------------------------------------------------------------------------------------------------------------------------------------------------------------------
-------------------------------------------------------------------------------------------------------------------------------------------------------------------------------------------------?------
--------------------------------------------------------------------------------------------------------------------------------------------------------------------------------------------------------
--------------------------------------------------------------------------------------------------------------------------------------------------------------------------------------------------------
---------------------------------o-----------------------------------------------------T----------------------------------------------------------------------------------------------------------------
-----BBB-------------------------------------------------------------------------------|----------------------------------------------------------------------------------------------------------------
---------------------------------------------------------------------------------------|---------------------------------------------------------------------------------------------------------------v
---------------BBBBBBBB-------T--------------------------------------------------------|---------------------------------------------------------------------------------------------------------------f
------------------------------|----------------B---------------------------------------|---------------------------------------------------------------------------------------------------------------f
------------------------------|--------------------------------------------------------|---------------------------------------------------------------------------------------------------------------f
------------------------------|--------------------------------------------------------|---------------------------------------------------------------------------------------------------------------f
-------------X----------------|--------------------------------------------------------|---------------------------------------------------------------------------------------------------------------f
-------------XX-B-------------|--------------------------------------------------------|---------------------------------------------------------------------------------------------------------------f
m-------E----XXX--------------|-----B-------E------------------------------------------|---------------------------------------------X-------------E---------------------------------------------------X
XXXXXXXXXX---XXXXXXXXXXXXXXXXX|XXXXXXXXXXXXXXXXXXXXXXXXXXXXXXXXXXXXXXXXXXXXXXXXXXXXXXXX|XXXXXXXXXXXXXXXXXXXXXXXXXXXXXXXXXXXXXXXXXXXXXXXXXXXXXXXXXXXXXXXXX-XXXXXXXXXXXXXXXXXXXXXXXXXXXXXXXXXXXXXXXXXXXXXX
