-----?--M--o-----o-------M---B---o--B-M----------M-------o-----E-----E--------B---------------------------o--?BM----oM---?---M-------------X?-?-------?-------------?B---E----E--Xo---------------------
-?-----E----M---EE--------------------E----?E-o-------------X-----M-----------X--M----B------EB--E----B----o-------?--M--?o--------o----------BE-E--------?--X-----------------o-----B----?-M-----M--?--
------------------E--------------------E------------------o---ME--E--B---B---B-----------?-B---------------------------------------M---M-------------o------------------------------------------?---M---
-o--------------M------?o--------------------?---M--------?---------------E--------------------E-o-----B-B--o-M--------------X----o--------X-----------------M--------------------B-X?-------?X---------
-o-----B---?--B-----------B--------M--------------?-----------B---M------------B---------------o---?--?----------------------------------------------ME------------BB------------B----------M------?----
---E---B----X----------?---?-----M--M-------B--------o------X----E-------------o------X--------------M--M------?-E---X--E-----X--------B-----------E-------------oM----?-----M-------------o------------
------------?------o---B-B-------B--M-----------------E---------------B-------?-E-?------------?----------M-------X?-----?-XM-?-X---------------?-?----------M------X-------?E?----------------E----M---
-E-M--o------?-------------------------?-----------------------------M----X----M-------M----M---E-------o--------------------X-----B-o--?------------------E-X------------------M------E---B--E---E---v-
---MM--oo--------E----?----Bo?-----E---?---E?---X--?----E----EM-------X-----E-----B-E?------X------B---B-?oo-------------M-M----o?-M-EEM------------E---E-oM-------B-Bo-o----E?------?--E--?-EE-EM-MX-f-
------X-M--MM------ooE--X--ME---?-oE?--X?-o---M--o-X--X-?--X-o----o-EMBM--E---------o----?--M--M-?--M-?M-----XX-------B-B--o----EME----B------MB-E----X--BX-----------XX-oX-X-----o--E--B---MB?M------f-
--XX-o-?--------E-------?---M-E--BB----------B----M---o--?X-----?-X---o--M---------o-ME--?X-B-oooB--?E---E--------M----XB----------M-oE------M-----X------------X-E--E-o--?-E-----Mo------BEM----BX---f-
-X----M----?----BX---M-?--B--E-o-----o----?--------X-----o----Bo?-o-B-------B-X---B---------oX-oXX?---B----B--X?E---?----B?XBM-Xo--X--E---o-X-------XX-X--X-??--------E--?X-----B---------EB-E------X-f-
--X--B-o-M-X----B-----?-M?------?-----o---------B---B----BXo-----o-E--X-Xo-?Bo--------EX------E??--M-----B-o------EE--------X--?-------B------X---E--?-------EB--?------------?M-------?--E-----o-----f-
-oT-T-T--TT-TTTT--TTT-TT--T-TT-B-TT-T-T---T?M-TTB----TT-TB-TB-E--TTT------TE-TT--T-o-TTTT-TE-?TTM--TTT--T---T-TTo-M-TTT--T?-T---TT-T-To-TTTTooX--T-----TTTTT--XT----TTT-TTTE--TT-TT-TBBTM-BX-XT-B--TBTf-
m-|E|o|E-||-||||o-|||M||--|-||M--||-|-|BB-|---||X--EM||o|-M|XE||-|||---|o-|-X||-?|?-o||||X|--M||MXX||||-|E-o|-||ME?T|||o-|-E|X--||E|?|o-||||-M-?T|-BT-T|||||-o-|----|||X|||-|-||-||E|--|---MM-|-X-?|-|f-
XXXXXXXXXXXXXXXXXXXXXXXXXXXXXXXXXXXXXXXXXXXXXXXXXXXXXXXXXXXXXXXXXXXXXXXXXXXXXXXXXXXXXXXXXXXXXXXXXXXXXXXXXXXXXXXXXXXXXXXXXXXXXXXXXXXXXXXXXXXXXXXXXXXXXXXXXXXXXXXXXXXXXXXXXXXXXXXXXXXXXXXXXXXXXXXXXXXXXXXX
