---------------------------------T----?--MM----|-o--o------------X---------------------XEE---M-----------------|---------o-------------B-------X-------------------------o-----------------------------|
----------------E---------------B--?-B------------T-------------------o-------------TX--------M-o--T-M---------------------------------?----T------------------------o-E--X-----------------------X----X
--------M------|----X--------|-------B-|--o-o-X-----E-o-------T------|----T-X------M--------------X--------B-|------o--?------------X-----------------------------------------------M---------?--------E
----------------------E-----X--------?-----------|----------o---------o--------------X-|---------------X----B---oE--------o-----EEEE-|--|-------o-M------------?-E------------------o-T-|--o-T--X------?
--B------XM---------------------------------------B?--B------?---o------o-----------------?------------------------E--?-|-------X--E---------E-M--------------------T--------B-X-----------------------o
-----------------------?---------------------B--------?-------M---B-E-?----|---------|o--------------------BTX----------M----T--B--M------M----------------|--T-----?----M---o-------------M--------X|--
-B------M----------B---------XT--M---M-----------T------------B-----E-------B-----------------TX----T|-TT-----------------T--------|-M-------XT--E--BT---o-X-----------T--E-----------|--MM-B----------T
-XB-----B---------B---T-X-B--B------B-B----------------------------|----?---o----B-------B--E-----------------Bo-----o------o------oBB--------M----M------|--------------B--o----XMM---B-X--------o---v?
-----BT-?-Xo?E-E-B-??EB-E---|X-|M--TMB--|-|B-T--TEMT?--|---M-----E---o----M--|o-----|E--T-B-----XT--?M--M---o?-X--?T--E--------X--XToB-o---o-X?-----E--X?-B-X--?--B---T|?-T------M?o-EM-E----MME-M--EofT
-----|--------T--T-----XM?-oB---E-?----?-----MM----------X---------T-o-----M-MM--X--o----?-|--o?----To--T---o-T-----B--E----X--o-M-?-EX-T-|-M--|--|??|-ME---Eo---|---M-----o-TBB-T----E-E?B-B-M--Xo-MTf-
--o---E----E-B--------TE-----?-M----T-M-E-T-------?---To-X-EoM-X----o--------EM|---?--|M-T---B-TXo--|--B-------To|-M?-T?--E-|X?---T--M--E-BT-B---------oEM|----M---o-TT-XM--?|--------|T-T--E--B-----|f-
---?M-o--BT---|-EBT------------TTTEoB----E-B---E---EMoo-X------E?-XX---------MMEB|?To---E-E??-|----EMo----TE-o--o?-X-----B--o---T--|o-E----|E--o-|BB-||--M|----?-----B-------B--BE-E------M---o--M-B--f-
--T-?--?---E---o----?-EE-o----o-Mo-B--BEMX--B-M------T-|---o------M--M?-M-M---MB?-X----T---XT----|-X-|-?---|--XB-?---X|----EE--T-----?-E--X--------------TT--?T-TX-X?-o--EX-?-----?----oBo-Xo-o|-oXMXXfE
---o-?-----E-----X-TX---?|---Mo----T--T--?---?-?--E-o-B-X-B--X-E----BX----M----B-?-|-X?-------Xo----EX---?T-EB-M|X-E--|X-----T-E?--|M----B?|--T|E--EM--M---B?B-----------T------??BXM--E---T--B-MX----f?
m-------?T--------M-----X-E-----B--------o--?|------------T---E--B-B--M---?-T-----X-?--o--E---B-----?|-----o-----X-MM-MB-T---|MM-B-X----|o-B--T--M-------|--EM--BToE------M-----|-?X|-E----oX-oX-??TB--X
XXXXXXXXXXXXXXXXXXXXXXXXXXXXXXXXXXXXXXXXXXXXXXXXXXXXXXXXXXXXXXXXXXXXXXXXXXXXXXXXXXXXXXXXXXXXXXXXXXXXXXXXXXXXXXXXXXXXXXXXXXXXXXXXXXXXXXXXXXXXXXXXXXXXXXXXXXXXXXXXXXXXXXXXXXXXXXXXXXXXXXXXXXXXXXXXXXXXXXXX
