-----------------------------B--M--------B-X----M-X-o-XB------X----------------E--------------M----------------------?-------M?-----------------------Mo?------X----o--------------------M----M---------
---------E-------------------?--------?--o----B----o--------------E-------X-------------?X-E----B-----------XM--------?---X-----M---E--M--------E-----o---X------------------------M---E---o----o-------
----------------------E-------B----?E-----X---??-----------------M-E--X--EEE-oo------------------------M-------------XB----?------oE-o-------o?-X--------?--------------------E-o--oE--Eo--M----X-M-----
-E---B-----E-----E------M----X----------M-E----E-o---M-?-------------------B------E------o-o?-B--M--------------B--------------o?----------o--------B--o---------X------o--M------------o-M-------------
----E--B------E--------B---B-oXB----o--B-------o------o---E------M-------------------E-----------------------o-?--M-------o-----------?---------------E--------E-o-M--------X--------o----?-------------
--o------------------------------------------?X---E---M-------Eoo-------B---------?-----------------M-?-X-MB----------X------E--o--E-X---------------------B-?-----------o---------------X---Xo----?----
--B-----------?---M----B---E--------------M----M?---E----E----o-?-B---------------?M--------------------X----------X--E--oX-------E-E------------o-----oE---------?---o----E------------B------X-----o--
-B------B----o-----------------------------X--o--oM-------E---B-o------oo---B-----------E-----BE--------------------B--X--E-M--B--------o-o-----E----o---------o------------------E----M------E-------v-
-X-?-BB----o-----E-X---BE----E----o----M-----B------M--X----------M-BoX?----E--BB-----o---X----X----XB-M?-?----B--------B----?-----E--B-M----E?E--M----M-EM----EoM---X----?-----o---E-MB?M-M--B-----E-f-
------X-M--MM------ooE--X--ME---?-oE?--X?-o---M--o-X--X-?--X-o----o-EMBM--E---o-----o----?--M--M-?--M-?M-----XX-------B-B--o----EME----B------MB-E----X--BX---o-------XX-oX-X--------E--B---MB?M------f-
-------M-X---?----o-----B----M-----------------------Xoo-?-?o-------X-X-BE--M-----X----M--MB-E--M-oo-BE----?----oo--o--?-----MM-----Xoo?-----M--o-?-----M--M-X---X---o-?-X-BM-------o-?------------Xo-f-
-X----M----?----BX---M-?--B--E-o-----o----?--------X-----o----Bo?-o-B-------B-X---B---------oX-oXX?---B----B--X?E---?----B?XBM-Xo--X--E---o-X-------XX-X--X-??--------E---X-----B---------EB-E------X-f-
-o----?----o------X---M------E---X-ME---EMB-----o-Eo--MB--oE-?-E----M-----MX-?-E---------X-----?-EXEXM--?---B------E?---------M---?---oX---X----BB--E--o--?--B--ME--?--oX---o---------B---------Xo----f-
---T-MBT-T--------TB-T--TM---TToT-MTT--E-T--MT--TT-TT---T-?T-?---TTTTT-TTXTTTT-T-T-TT?TT----E-T------T-oT-T-T-T----TT-ToTo---TTTT--TTT-ET-o-TTT-T-T--T------T--TTM-TE-T-TET-TT-T-TTB--TTT----oT-T--TB-f-
m--|Mo?|||M-T-o-MX|X-|--|-X--||-|--||M--o|-?-|-T||o||B--|E-|---Xo|||||-||X||||X|?|-||-||X-T-B-|M--T--|?-|T|||o|--Xo||E|-|-o|-||||ME|||--|-T-|||?|-|--|--oE--|EE||Mo|-E|-|o|o|XX|M||---|||---X|||||?|-Mf-
XXXXXXXXXXXXXXXXXXXXXXXXXXXXXXXXXXXXXXXXXXXXXXXXXXXXXXXXXXXXXXXXXXXXXXXXXXXXXXXXXXXXXXXXXXXXXXXXXXXXXXXXXXXXXXXXXXXXXXXXXXXXXXXXXXXXXXXXXXXXXXXXXXXXXXXXXXXXXXXXXXXXXXXXXXXXXXXXXXXXXXXXXXXXXXXXXXXXXXXX
