----------------------------------X---------------------------------------------------------------------------------------------------------------------------------------------------------------------
--------------------------------------------------------------------------------------------------------------------------------------------------------------------------------------------------------
--------------------------------------------------------------------------------------------------------------------------------------------------------------------------------------------------------
---------------------------------------------------------------------------------------------------------------------------------------T----------------------------------------------------------------
-----------------------X---------------------------------------------------------------------------------------------------------------|----------------------------------------------------------------
---------------------------------------------------------------------------------------------------------------------------------------|----------------------------------------------------------------
-------------------------------------------------?-------------------------------------------------------------------------------------|----------------------------------------------------------------
---------------------------------------------------------------------------------------------------------------------------------------|---------------------------------------------------------------v
---------------------------------------------------------------------------------------------------------------------------------------|---------------------------------------------------------------f
---------------------------------------------------------------------------------------------------------------------------------------|---------------------------------------------------------------f
---------------------------------------------------------------------------------------------------------------------------------------|---------------------------------------------------------------f
---------------------------------------------------------------------------------------------------------------------------------------|---------------------------------------------------------------f
---------------------------------------------------------------------------------------------------------------------------------------|---------------------------------------------------------------f
---------------------------------------------------------------------------------------------------------------------------------------|---------------------------------------------------------------f
m-----------E--------------------------------------------------------------------------------------??E?--------------------------------|---------------------------------------------------------------X
XXXXXXXXXXXXXXXXXXXXXXXXXXXXXX-------XXXXXXXXXXXXXXXXXXXXXXXXXXXXXXXXXXXXXXXXXXXXXXXXXXXXXoXXXXXXXXXXXXXXXXXXXXXXXXXXXXXXXXXXXXXXXXXXXX|XXXXXXXXXXXXXXXXXXXXXXXXXXXXXXXXXXXXXXXXXXXXXXXXXXXXXXXXXXXXXXXX
