---------------------------------------------------------?----------------------------------------------------------------------------------------------------?--------------------X--------------------
-------------------------------------------------------------------------------------------------------------------------o------------------------------------------------------------------------------
---B---------------------------------------------------------------------------------------------???----------------------------------------------------------------------------------------------o-----
-----------o-----------------------------B---------------------------------------------------------------------------------------------------------------------------------T----------------------------
-------------------?----------------X------------------------------------------------X-------------------------------------------------------------------------------------|----------------------------
-------MM--T---------T---------o--------o-------------------------------------------------------B------------------------------------------X-------------------------------|----------------------------
-----------|---------|---------------------------------------------------------------------------------------------------------------------XX------------------------------|--------------------------X-
-----------|---------|---------------------------------------------------------------------------------B-----------------------------------XXX----------------T------------|--------------?-----------Xv
----------T|---------|-------B----BT--------------------------------------------------------------------------T----------------------------XXXX---------------|------------|--------------------------Xf
------o---||---------|BBBBBBB------|-------------------------------------?-------------------------XX---------|-----------------T-B----X---XXXXX--------------|------------|--------------------------Xf
----------||-B-------|-------------|-----------------------------------------------------o--------------------|-----------------|-----XX---XXXXXX-------------|------------|------T-------------------Xf
----------||---------|-------------|-------------------------T-----------------------------B------------------|-----------------|----XXX---XXXXXXXX-----------|---------BBB|BBBB--|----T--------------Xf
----------||---------|-------------|---------B--------------o|------------M-----------------------------------|-----------------|---XXXX---XXXXXXXX-----------|------------|------|----|--------------Xf
----X-----||---------|-------------|-------T-----------------|-???????----------------------------------------|---------B-------|--XXXXX---XXXXXXXXX----------|------------|------|----|----X---------Xf
m-E-XX---E||---------|-E-----E-E---|-------|---------E-------|----E------------------X-----E----E-------------|--E--------------|EXXXXXX---XXXXXXXXXX---------|------E-----|------|E---|----XX-E-E---EXX
XXXXXXXXXX||X------XX|XXXXX-----XXX|XXXXXXX|XXXXXXXXXXXXXXXXX|XXXXXXXXXXXXXXXX-------XXX--XXXXX---X------XXXXX|-o--XX-----XXXXXX|XXXXXXX---XXXXXXXXXXX-----XXX|XXXXXXXXXXXX|XXXXXX|XXXX|XXXXXXXXXXXX--XX
