---|-----------X--X---o-------|----E-o----|--M----------------EX--E-------X---------o-------------o--?----|-o----------------B-----------M----?----------X-----M-TX?------------E---?--EB-----B-E---M?-|
------------------|------B---T---------------M-TXX--|--X------------o------------------M----T----------------------B--T-----?------------------|------o------|B-------|--------------|-----------B-----X
-------X---E--o---------------------o---|X-----------B---------T-----?-----M-X--T-----M----o----------?--o----E-|------------B------------X--?-----------------X----T--------------------o---------T---B
-M--------------?----------------------------X-|--?------?-------|M------o---------------T--o--------------?-?--X-----|--------X--------T---|-X---------------------------o-X----------E----------X-----
-----T-------------E-M--B-----B-----------------------------T------------------T---------------|-----M---------------B----------M------E-o---------T---T----E-------------------T----------------------T
-----E--?----B---o--E-------------E-M---------------B------?-----|M------M--X--------X------------------?-----E---------X--X--------|----E---------E--XM----T--------------E----?------------X-----|---X
-------------B---------E-------EB|------T---o--------?-E-------------------------------X------------E---|---MX----------------------|--|-?----------?---------M---|E--------|---?-----------------X--o-o
-----------------------------------|-----------T--M-----------X----------o------E--------------E-----------------------------E------M---XE--------M--M-------?T---o-----------B------|T-----|---------vM
---T?---E--X------?-?T--oX-M-TT-------X---------o|-M|B?---X--------E--o-X------X-?--------E-T--XTo-o-T-T-B--TT--E--EM--X--|---oM-------??-?----MTB--------E-E-EBX-------T--|EEE?----E-B-XE--M--MMoMoE-fo
-----Eo--T------B--X--T?-----EE----B-E-M-E-----T-Bo|E--|------o-BEB|-----------XT-----o----Eo-BXT---T-||-----MT-o--?|X--M---T--TT--B-oMMT----o?----------o---B--T---M----M|---B---B-------?-|-XB------fB
-T----|--E--EME----o--X-BB-------|--E?TT----MT---||-o--M-?-M?||-BoB----X-B|oTE--T-T?ET-|--------------B--T|-M-B-T---B--T?|TXB-E------?--E|-MTT?-T--?----X-|-------XX--?B--------|----M--B--EX|XE----?EfT
-?----BX-T--M--?-E--T|---EM-B?X-o--M-|--B--TB-|--E--TEXM--B?-XBo--||-?----T-----??--M----T-T?-------E-BT-----|---MTT-T-T--?o-----|---X---?-o---?--E--B?----|XB-o-M-X-?EM---M|---BB--?---B-?--B----XM-Tfo
--|--X-----Xo-T-BX----XB|M-ME---|-EB-----XE|-----X-?-M-----EE-?X-o-TT-----E-------E--o-B-M---T---o---E-|M|-BBMXM-T---B-B----X--XoX--------ME---?o-oM---M-M-|----X--B-------?M----M-?T---E--T-EE?T---X-fM
----------------?---M-Bo-XTE----|-M-----|-o--T-----o--o---X---M--BM---------MT------B-E--|B-TX-B------E-X--XMX-B-|--?---|-X-o-X---o---------M----B--X-----|--|--------E-M-M--XB------o--?----BE--E-X--fo
m-XBo-----BMX?M-?-M-----|TX--B---E----?----?XEX----B----MB-X---?XE-|MT---T-|-|M--o----T-?--?-o-|--|-----oB-TX-?X----?---oT---X-----MM--??XXE-||M---B-M----X---------T|T---X|-|T---X--B--T---X---oT--oB?o
XXXXXXXXXXXXXXXXXXXXXXXXXXXXXXXXXXXXXXXXXXXXXXXXXXXXXXXXXXXXXXXXXXXXXXXXXXXXXXXXXXXXXXXXXXXXXXXXXXXXXXXXXXXXXXXXXXXXXXXXXXXXXXXXXXXXXXXXXXXXXXXXXXXXXXXXXXXXXXXXXXXXXXXXXXXXXXXXXXXXXXXXXXXXXXXXXXXXXXXX
