-?-----E--E------------?----M--------B----------------B-X--------M--------------------------M--------------------?---------??------------EE---o----M---------------------M---------------------B--------
-------------------------------------------B----------E-----o-------o------E-?E-o--BE---?-----------B-----MB-M-----E--------X---o---M-X---M---o----------------------------------------------?----------
-----?E--B-------o-----X-E-----?-----M-------M--X----XoX--------?--o---o-------B-------B----------------XBoM---------B-----B-?---------M--X-X------o-----------M-o----------o----M-M--------------------
--------B-XB----Mo-----?--?----X------?--------M-X---------M---M-----E--------------M------o----o--------------------------------?------------o-----------?-X----------B?-----B-----E?--oX----------?---
-------B------o---------E------------?--------?------------------------X------------------M--o---------MB-------------?-----------E----E-------?----M--------o----?--------M--?--------------X----B-----
-E----o-?-M----------o--M--------?--------Mo--------------------E----E--------?-------------E---------?----XB---------------?-------------------?---------------X---o?-----------E-M----oE-?------X-----
--B-----------?---M----B---E--------------M----M?---E----E----o-?-B---------------?M--------------------X----------X--E--oX-------E-E------------o-----oE---------?---o----E------------B------X-----o--
-B------B----------------------------------X--o--oM-------E---B-o------oo---B-----------E-----BE--------------------B--X--E-M--B--------o-o-----E----o---------o------------------E----M------E-------v-
-X-?--B----o-----E-X---BE----E----o----M-----B------M--X----------M-BoX?----E--BB-----o---X----X----XB-M?-?----B--------B----?-----E--B-M----E?E--M----M-EM----EoM---X----?-----o---E-MB?M-M--B-----E-f-
--o-----B----BMB---------------?-Bo-E------E----o------ooE-----------------B---------o-------E?-ME-M-B--MX--X--o-o---BE---M----?----o--X---X---M-BB?--?----------?--?-?M-B--X----Mo----M---o----------f-
--E-------X-------?o-E-----M-o-E-X---------?----------XMB----------M-??-X-B---BB-B-----oM-?--------Xo--BB------------?-?-------B-------------oM-M--oB-?---?-------------------o?-M------E-M-oM------oEf-
----EE----o----B---?----o--E-----X-M---B--?---X-o-------------XXEX--M----------M---?--------o-----BE-------M-------B----E--B--?-X---------X?o--B-EX-E--------BX--oo---MM?-----B--------X----------o?-Ef-
-o----?----o------X---M------E---X-ME---EMB-----o-Eo--MB--oE-?-E----M-----MX-?-E---------X-----?-EXEXM--?---B------E?---------M---?---oX---X----BB--E--o--?--B--ME--?--oX---o---------B---------Xo----f-
-----MBT---T---T--TBTT-TTMT---To--MT-T-E---TM--TT----TT---?--?T-T----T---XT------T--T?-T--TTETTTTT-----oT-T------------oToT-------TT---E-To--T-TTTT----TT---TTT--M--E----E-T-TT-TTTB-----TTT-oT-TT--BTf-
m------|E-B|--T|--|-||-||-|---|M-?-|?|-o-B-|--|||T---||--T--TE|-|T---|--M-|?M-E-||-||M-|E?||-|||||-M-oT-|-|-------E-M|-X|-|--M|MT-||-BE-o|o?T|-||||MM--||-M-|||-T-----||---|-||-|||M--M--|||--|E||Xo||f-
XXXXXXXXXXXXXXXXXXXXXXXXXXXXXXXXXXXXXXXXXXXXXXXXXXXXXXXXXXXXXXXXXXXXXXXXXXXXXXXXXXXXXXXXXXXXXXXXXXXXXXXXXXXXXXXXXXXXXXXXXXXXXXXXXXXXXXXXXXXXXXXXXXXXXXXXXXXXXXXXXXXXXXXXXXXXXXXXXXXXXXXXXXXXXXXXXXXXXXXX
