---oT-------?----o------|-------T-----MME---T-M--o------------X-------X----------M------|----?------X--o--------M-|---------------------------------------------T-----M--------B--------B---E-To--------
---BT----T----------E------B-E--B-B-----X----|------E----oMoBX-----?M---o------------E--------------------X--------o-------M--B--o|M------E-----?---X--------X-M--B-------X--------------B--?-T--?--M--T
-M--------|oTX-----T--------E--------------T-----o---------B-------?---o---E-------------X----B---X--------E-|-------------B-|--|-|?-M-----------E---M----|---M-------o-----------------X---X---|------E
-----------|-------------T--M--o---------E----------------T-X----oM--M-------|--------T---------------M--------------o---------------------o---B----X--E----M----X-----------------B--------E-?--XMo---E
--E------------------T-----------------?------X-?-|-----B--|-----o--------o-o------T----|B-------M-Xo--------B----------|--E------------------M-||?----------B-------------B-E------EE---------------?-E
----?------------------------oM-----?o--|-E-------------------------------T--------BE------ETX-E-----E----------o------?---------|--------E-----E-------E---------------------------E--------o---o---T-?
-?----------E----o----E-------------X-------------T-|M-------------------------E----------BM---?----M---o-B---------M-o--------------|oM------|----B---|--------------M-----X-|--o------------M---------
-----|-----------|-------E---T------------o--------T-----|--------------M------X-----------|-MM------o-----?----|--?-------MT-------X--M-T-----------------?----?--------T-----------|-?E-------------v-
---E--E|---M-------X--|--Xo-----M|------BE-E-EB?EB---XX--Bo?T|-----T----|-|--o--|--E-MEoX--M--Bo-|---X-----BBB-o----T----TTX---------------X-E-T-o-X----------o-----T-M---TX--B----X----?------T---B-Mf|
---B----|--X--M-T---------EX--X-?-?--X-T-MT-o---T---X--T--|TX------B?-----|-EX------X---|-o--------oM-T--M--XT------MoB-?--o--M--|-o--Xo----M-?TB-o-----|o-oB-E-B---X-X---o---oM---B--B----o-X---TM---fX
--MB---o-|X---B------|-|-----M----M----B------X-|--|-XB---B--X----X-----M-X--?MT--BoXMo-?-E?--BX----B-X--B--BB-----E-|--?-----B-----|--T------B-M|-------B----MX-?E----B-----o-?--E--|-|?--||------Bo-fE
---MXM-E-M-M-M-TE-------B-E--B--E---oM-MX---?--------|-B----X--|-EE--||--T|-----o-M-BM-TBE-X-E-EE-?|---T-T?X|XB---?-M-EB-B---BEo---EM-T---X--oB--o?-----|X---X---TX|-------?--?oXT------MT-B---|--T---fE
-oo----M--T--M-?T---o----------X----B-o-M-T--BE----MME---?--BX---T--T----------T??|?-?-M|-?-B-X---MX--X---?o---o-??-To-o---|?|--E--B?-TB-Eo-------B-TX--E---------BX---B-----E-o?-o--X-B--?--?E----oT-fX
----M-------o----o-oo-ETBo-E---T-?T---?M-oo--|EX---oTT--X-?-E|----X-B-XXBE------o--X-??X-XET------E-X-------ME---?--E-----BE-T------BB----o----M|--B--?--||BX-M--M--|XB-M-?-------|--|--E-B-M?-B-oBX-|f?
m|--T---M----o-|-?------------X--XE-|-----M---XE------------X-----XT|------|ETB---T-B-EE--T-?-MEo-?-?T-T-----|--MX--T-BB---B-|o-ET-----MMTM-?E-B------|--X-----E-----E-?E--|XE--Eo-?X?-----T-o---------E
XXXXXXXXXXXXXXXXXXXXXXXXXXXXXXXXXXXXXXXXXXXXXXXXXXXXXXXXXXXXXXXXXXXXXXXXXXXXXXXXXXXXXXXXXXXXXXXXXXXXXXXXXXXXXXXXXXXXXXXXXXXXXXXXXXXXXXXXXXXXXXXXXXXXXXXXXXXXXXXXXXXXXXXXXXXXXXXXXXXXXXXXXXXXXXXXXXXXXXXX
