---------?M---T-------X--T-EM----?---------B-------------X-----M---M-M---?E--------------------------------------------------------o?-----B|-------?--ME------------------------o-----------TT-TT------T
------o-B----?--------M-----------E-----|-|---------TB-------B-X--?-TE----?-T--------Xo|-E-----------------B---------o-----?---M---?-E----B-?---------------o---------------?--X---X--M-------E--X-|---?
------T-B---------------------o-----?--|-----T------------------?----------------------|----------E-X-X----B---E----------M----M-------------X----------|-------X?-----M-----B-------------------------X
-------------|-|-----T-------M------o---?-----?------|---T-------M----------B-T------ME---T---------------------T---B-M-------------|---|------------B----E-----?-?-------M---?---E--------|--B------E-o
------------------------?-------------------------------|-?---B---|---X----B-----------B-----------------------------|---------|-E-o----------T--------E|E--E-------E-X-----------------ET-------------o
----T---Xo---------?XT---oM--X----M-------------X-----B---------T------|---M-----------------X----------M---------------------------------------|--------X---E-|---B-|?oT------------M----------B---o?-B
-X?-----|-?E----------B-|-----|-------------------------------|------------------B------o------M-?---T----BE---E----------------------T----T----------------------------------------------------|------|
-B|--|B------------?------------?---------E-B-----o------------------------M-----------X---?------o---X-M---M-------------B-------?----------E----------E-T----E------o-T-----X--------------E-----X--vB
--XE----X---|--M-EE|ooT--T|--?|-?--E--------o?-------?--T-----T|---Eoo----------X-----|-BoB------T---E-M?----?--o--M--MB----?---XBM----BB--?--M--|---E-X--M-M--|-M------B--?-B-|--M--XT---B--TX---o--ofX
-X----M--?T--TT----X|o-----M|---?|-TTB|--|-M--T-|----E-M--M-?o-MT-MT-|---M-M---EB----|o-?-T|X?---------Xoo-|---o-?--oM|-------B--o-------o-|--oTEB-?--T---|--o-M---T----o--o-----B-M----MMXE--?X-T-|--f?
----M--------X--E-TM----------BB--o---EM?-o----TM--------o-o--E-ooE---|B----B-|--B?TT---|Xo-TTTE--M--B--T-E-o--|--X----E-MM--T---X|---o----M-?-MX-----o-M?-T------T-B---M-----M|----o--B-o-T--Eo?-Xo-Mfo
--B|E-M--?o--E|---|--XX?|------M|--T----M--MEX----?---?B----X--o-MB-o-MBE-XXoE-T--M--E|--E--------XBM--------T----M-------ET--|---M-T--?-B--o---TBB?--X|-|-----M-oBToE-B-|---B---X----X-T--o-B-B-B----fo
--oT-------|-|o----------B----|--MBX-?X---XX-----E--?X-T-M-----?oE-|-o--------||-E--T-M|--|-E---|MX-T-------BEX-----M--?--XX--o-?-?-XE--o------o-M-XT--?-?----T--B-----B----------------------?-B--B--fo
----T---------X---M---T|--oE--X-oX-|---T----T---EX---|T---X-----|-MM-oM?X----o--MM--o-M?-----o----M------TB--E----?o---??-M?M---X---B---|---B---------E-Bo-?M---------TE---oB--X------o----B?-M--XTT--f-
m------?-X--E--Bo-|-Mo-------|-----?-o------??---M-?--|--M-?----MM---o|?-T-M||T--M---|-MM-oE-X-|E-----B---?oTM---B--?-X--o?E--X----M----|M-oo------oo-T-E---|ET--XM---------ETTX--|-TB-----X---|-X?---XM
XXXXXXXXXXXXXXXXXXXXXXXXXXXXXXXXXXXXXXXXXXXXXXXXXXXXXXXXXXXXXXXXXXXXXXXXXXXXXXXXXXXXXXXXXXXXXXXXXXXXXXXXXXXXXXXXXXXXXXXXXXXXXXXXXXXXXXXXXXXXXXXXXXXXXXXXXXXXXXXXXXXXXXXXXXXXXXXXXXXXXXXXXXXXXXXXXXXXXXXX
