------------------X-------------------------------------------------------------------------------------------------------------------------------------------------------------------------------------
--------------------------------------------------------------------------------------------------------------------------------------------------------------------------------------------------------
--------------------------------------------------------------------------------------------------------------------------------------------------------------------------------------------------------
--------------------------------------------------------------------------------------------------------------------------------------------------------------T-----------------------------------------
--------------------------------------------------------------------------------------------------------------------------------------------------------------|-----------------------------------------
--------------------------------------------------------------------------------------------------------------------------------------------------------------|-----------------------------------------
----------------------------------------------------------------------------------------------------------------------------------------------B-------T-------|-----------------------------o-----------
---BBB------------------------------------------------------------------------XXX-------------------------------------------------------------M-------|-------|----------------------------------------v
------------------------------------------------------------------------------------------------------------------------------------------------------|-------|----------------B-----------------------f
------------------------------------------------------------------------------------------------------------------------------------------------------|-------|----------------------------------------f
-------------------------------------------------------------------------------------------------------------------------M---------------------------B|-------|----------------------------------------f
------------------------------------------------------------------------------------------------------------------------------------------------------|-------|----------------------------------------f
------------------------------------------------------------------------------------------------------------------------------------------------------|-------|----------------------------------------f
--------------------------------------------M---------------------------------------------------------------------------------------------------------|-------|o---------------------------------------f
m-----------------------------------------------------------------------------------------------------------------------------------------------------|-------|--E--E----------------------------------X
XXXXXXXXXXXXXXXXXXXXXXXXXXXXXXXXXXXXXXXXXXXXXXXXXXXXXXXXXXXXXXXXXXXXXXXXXXXXXXXXXXXXXXXXXXXXXXXXXXXXXXXXXXXXXXXXXXXXXXXXXXXXXXXXXXXXXXXXXXXXXXXXXXXXXX|XXXXXXX|XXXXXXXXXXXXXXXXXXXXXXXXXXXXXXXXXXXXXXXXX
