-----------------X------------|-----?-------B-B---------------X----------|---------B------|-----X-----------TM----------EX---X-------------o-----------o----------X-----E---?------------X--T----------o
-----------X|----------------------X------M-------|------|--------------------X-T----------E-----E---------?B-X------o------M---B|------------------X-o---X-------E----XT----M------------------|------?
-------------------|--------------------|-------------------?-T------------E---B------o?-------------------X----M?--------E---M----------------B?----?----To-M--------------------------------?---------
--TM--o-o--|-X?-?-----E-----------o-----|E----M--------------?|---------X?-----M------------------------B----------M----T---?-------------T-------------------------------o--------|-------B--TX--o----B
----|--?-------------|-?--X-------------------------M----ME---|----------E----------------EE--------E-------MM---------------o|M---?----o|-X-------B----------------E--|--B---T--------E-----X?--------?
-------?-----oE--?---TX-----------------E--?-----------M--|--MB-------------------Xo-----B------B--M-------------MB--Xo-T--|-------------o----------E---M?--X-----E-------E------oo----o---T-Mo------T-M
------------X---?------T--------------M------------------------------?------E---T-M---E-------o------------------------E---------TMB------X-----------X----------------B-------------------------------B
---M-----------T------------B-------------o----T----------MX----------------------------------?------------M--X--T----------------------B----------------------?---X-----------------o-------------X--vE
--------||oE?E--?-?---??T----MEX-o---|--Eo-T|------X-o---?--T---M--?--o---|X-----------X?-X--B--o--?--M--ME-B-?-o---|T-----TT---------oME?E-ME-?|-T-X-MoE-M----------|TBM-----|BXTM?|--Bo-o-o-o---B--Ef|
-o-------Xo----X----B-----E---M--M-B----?-M-M?-----?-E-T-o-o---oEB?--B-----?-----X--------ooo-TB-------MBMM?------o----?-|-TBM--------?E-T---B------ToX--M-oo---B||----M----T----?T-B-M----T----TT----fE
--E-B-X-------X---M-M--T--|?-----?T-MTT--?---E?------MX----o|---------|?--------o--B--M--X-MoEX?B---o---o?ET--|T--M-?To|XX------E------X-----XT--E-M-E-M-|-|-|-----TT-T--X?------?T----B---E-|----|--Ef|
------------?-M-MB-o--T|MT-E|-E--E---|B-T--?|E------?|-MBB-T--X---?-----X--?-o---o---B---ooEX----MBX-----B--M----oTEM--B--?X---T----?---BM-XB-|BB---MMT---o-BE---BB----T--|--o----o-?---E-To-oXEoT---Xf-
-------B----o----X----o-?ET-----|o----BM?------M--X-----X---Xo---o-----XB-----?-X--E-o----M-----|o---EMo-XEE----T--MEoMM--?------|---------T------BTBE?---?----E---B---E-|X-T-------E-|E---T-TET?----Mf?
-o-o---M-B-M-B-----E----MMo--M--BoM------M--X--B---B---B-T--B----------E-B-oB------?o--MMMoo-M-?Eo----E-?---------X--X------X--E---------|----oM-MT-M--|---M--|E-oo---M-?--EM-oTM---E------E-B---T--o-f?
mB-?------------T-------------M--B|-----?BE?-o--?---M--B----X------EXX-M-T---o----BE---E-E--B---X--EB-XEB--o-|T------TME-B-?--M--M-------?--X-----|--------XE------B---|--T--||-oT-------?oXE---?------X
XXXXXXXXXXXXXXXXXXXXXXXXXXXXXXXXXXXXXXXXXXXXXXXXXXXXXXXXXXXXXXXXXXXXXXXXXXXXXXXXXXXXXXXXXXXXXXXXXXXXXXXXXXXXXXXXXXXXXXXXXXXXXXXXXXXXXXXXXXXXXXXXXXXXXXXXXXXXXXXXXXXXXXXXXXXXXXXXXXXXXXXXXXXXXXXXXXXXXXXX
