---M----------------XX--B--------?---M---------?-------?-M--------|XB-B--------------------------?-T------T-----oM---X-o?o------T------T-----------EE-------M-?X--|--TX-------M--------------------X---|
--?-T--------X|----------|--------T------------X---E-------------oE---?--o----------o-----|----M---------|----?-----B----------------M-M----o----M-o----?---------BT---|----T-M--o------E--------------B
----------------------B--EX--|--M--|-------------------B---?----------------------------------B-B--------------------------------|-------------------------------------o-------------X-----------------?
--M---Eo---M----------X--------o-M--------------B-----?--T--------?----o----M-------T---------------------T----|-----------M----------------EB---|--T----o------M-----M---o---------------T-----B--M---?
---o------?E---------X----------X---------M--E-E?------------XE-----?-------------X---------------o----------------E--------?---MM-ooo----T-----|o-----------?-?------B-TBE----X-o-|-B-----B-----------?
---?-B----|----------------------------------M---M-To---T-------M-E|-E---------------------E------T-E?--------------X------------------------o--T--------------M---M-M-----B---------------------X|----?
----------o-----------------?----X---M--------X---Eo--?-------B---||-E----o-------B---?B-X------o----------B-o----o-X-T------------X----E-----------B---X------------o----------------?-B--?-----------|
-----|-----o-----T----------M-o-----?-------?----|-E-------------|--o------------------T---T--o---------X-?-----------------------E?B-----------------T?-----------M--E----o--------------------------vX
-------E-------E----T-BB|-B-----EM-----?-------|--oXB---|---E-o--oB---|M-MEo-B?B---E-----?-?EE--MX|E--M---T---BM-----TT---?----T---?--B-E--M---BE-o--X-X--ME----E?---MB-M--|MM-|-B----T?-o-X--E---X--Tf|
--E----X--E-------?T--M-E--X--------M-?T-----o|B|---Xo---E-----B---B--X-----o----T---?---T?-M-|---?-----T---T--M----?--o---ME---|----?---------oM----?-----M-o-T-?---E-B-B-o--B?----X-M-B--|X--oB--oB-fT
-o--o---M---X?-o----T-||M-?----o----XE-E-X-----TB------B----XE--o--B--M-?----E--?-------B|---E--------|--T--Eo?--E-E-----E--M---o--T--?EBX|--o-----X----M--?-?|-----X---T-|--o--M--T----T--E-T--ET-T--fB
-M--B-----E--?-----TM|M-?-?X-E--ET-M-?B-X-o--?---|--BB?T-X---?--BT---o-|-M---E---|-M--------X?----XBB--|M---?o-----X-|-oE---X?-E---M----|-|-?----E-|o?-B---TM---XM-XE?E----------?-----TB--M--?------|fX
--X-EE|--X--M-M--TB?-----E------T--?-M-----o-----?-B|-----|-T--|-MB----------X----------|---?---?M--E---|-|-?-------M--B--M-B------oE-B-----T-----B--Xo---X-?---M----o---|-ET--?---o-----|---T-B---E--fM
-T----XX-----?T------E----X---|------|X-BX--T-T-|M-B----|o-|------o---X----|---B----E----E-------B------o--EE-oE--T-|-T?----T--X-?--------B-----Mo----o--B--X---E?-------B-B|--E--M------o--B-X-X||o--f?
m?-B-X--MB------B|?-B-M-B-TMEoE--MX---E----|M-XM?-X-----------B--BX-Eo----M-E-Bo?-oX-X---o---?-B--|-E?--|-X--E-??oXB-E-E---B--X-----?------B?---M-T----E--X----M-o-?T-M--?o-?-T--?------|----|BE-E-T|?-B
XXXXXXXXXXXXXXXXXXXXXXXXXXXXXXXXXXXXXXXXXXXXXXXXXXXXXXXXXXXXXXXXXXXXXXXXXXXXXXXXXXXXXXXXXXXXXXXXXXXXXXXXXXXXXXXXXXXXXXXXXXXXXXXXXXXXXXXXXXXXXXXXXXXXXXXXXXXXXXXXXXXXXXXXXXXXXXXXXXXXXXXXXXXXXXXXXXXXXXXX
