----------------B---------------------------E---B-o-----------------------------------------------T------|------------B----?--E----E-o----o-----Mo-B-E-----|----------?----B------B|--------o-T---M----E
-?---oM-oB--X--B|B---------TMM--o-------B--B-X---|-----M----|----E---E--o------------------B--o---------------B----|o------------|---M--M---BEB--------XB-B|----?-----X------B-|-----------------------X
-----|---X-----------X--------T----oo--T?------X|---------------------------------|----oB--o-----B-T|--T-X----X-----------------M-----------B----B-M--------M-------B----------T----BE--o------------E-o
----|------------M---------X---?------|-------X--|-BBE---------?---M------o---------------|-----M----T---------X|--?-----ME-----Xo---B----E------o-------------E-----------o---------|---X---M-----o---E
-------X---oT----M-------E-------E------------------------T----|---------------oB-----o------------E--------------------M-----oX?----M--o-----?-X----------M---------------------?--------X----M-------o
---M--------E-------o-----------------T-----------------------------B-|---B----M-------M---o---T----TB---E-E--------?o----------------T---M-----------------E-------------?B--o-----M-B|---------------T
-----o------E--B---|-------------T------E--|---E---T|-B--B-----------|----E---------?|X-----------E-X---X-------|--T---------o----E-----B----------T---?--------MMM?T---------B--M--------X?----o------o
---------------o|-----X------?--M------------------------B------M---X----B-X---------------------------T-------------------|-M||M-------------------oET-----------------------o---------X--B-------T|-vM
-?o---o--M--------?B-MM-|---MB?|--X--B-----M--T-E-----oE-M---B|-X----T--E----o-------?-------Bo-TE---oBT-E?E--B--o----Mo-XE----------E-oBoT--T-------B-M------M-M---TT------o-?---E------M-TB--------?f?
---|--??-E----|-----TBo---BMX---M---?----||----??--|-|--|-------o----B--M--M-|------M--T--|TE---o---|BM?M-----XX-o----E--X-o-?o?--|-B-BETT?-----M-X-----E---TE---MBM?---B---?------Eo--TB--M-------TT-f|
-X--T?-o--X---o------B-----X---o-o--|o------B---M----o?o----------E-X-----|--oT--B-T--X------B---|M-o-XB--oT--Bo---MX-||--?--?E-?E---ET|--XT---Bo-E------------o-T-B------E--------BM---XME---MX-----Bf|
---|--To--|--------BT-X--|------|M--XE-------XEB-E---E-E|-X-?-|-MM-M-----EXM-?------Bo----XB-B?M-X----|B--E|-?---------X|--o--Eo|---ME-----o-B--M-X-M-E---|--|--M--?-Bo-XT--------E-X-o-TB---BB-ooE--EfM
-o--?M-E-|-?E--------T----ET--oT----------E--X-?BE-------------o-M------o-Xo?M|-----MX-------X-?M---T-B-??--BMX--X---T-XoT-T--|---M--E----BX---X-X----o-----------X---E-E-MT----T-M--|?-o-BX-|X-------f?
----T-B---MB--------X-T---M----M?-M-----oo-oT---M-|BB--?EoMX-B---o|--EX-M-BE----------TE-------?MMM-?--M-M-----?-B----B--?-E---M--TM----BM--EE-?----X----|---T--M----M----B||--ooX------?--E---ME---X-fX
m--M-E-M--T----o-B------M------|-----|T-X---|-oME-X-?---M?-B-?-B----B---X--XB?T-o--B---T-X----|---B---E--M???-|--o----------|--o---T---oEBo---TMT--?-B?--T-T--------o----------M---|-----M---M-X--E--MX-
XXXXXXXXXXXXXXXXXXXXXXXXXXXXXXXXXXXXXXXXXXXXXXXXXXXXXXXXXXXXXXXXXXXXXXXXXXXXXXXXXXXXXXXXXXXXXXXXXXXXXXXXXXXXXXXXXXXXXXXXXXXXXXXXXXXXXXXXXXXXXXXXXXXXXXXXXXXXXXXXXXXXXXXXXXXXXXXXXXXXXXXXXXXXXXXXXXXXXXXX
