-?----------------------------------------o-?------------X-------------M-------X--------------o--B-o-o--?---------------------------------o---o-|----X-|-M---------------XX---------?---------B-T?-X---M
-----o-?X-----|-------------------------------------?-------------B---XM----------------B-T----------E--T-------------o---o--------o------------X----------E---|---------?--------T--------------------X
-----B--------o-----------X---------------E-------|--------E-----------oM-------M---------------?--B----------T------------------------E--T----------------------TX-----------X------oX-----------M-B--B
--X----X----B------------------|----------------M-------T------------o------------------oT?X---------?-------------------T-------------o-------------------?-----M----E--------------B----------|-------
--------------------?--B--T--------------B-E---M----------|-T-|---E-------o---?---B-------TB-------B--?------T|---------------------M--------X---o---B----o-------M-------------E--XX-------T------M---X
-------B-X-----------MB---?-------M-T--|M--E-----------------------?--B----------------E---M-------E----o---E------------T----|-|----?-T---?-------X--------------T---X---M------?----T----------------E
--B---------?-------------------M--------------?-----------T|-----------B-------?--T--?---------T-o------E-------?--ET-E--------X----X-----T----E-o----------o---------------B-----?-------E-|---------X
--M----X--T--------E-M-----------BT-----oB--------E---M----To-o---------------M------|---------X---E------B-----T-----------------------o-----??------------M-X--B---M---------------o----------------v-
-BX-B-T--o-o-o-------------T-B--?----E-------?----o?-oo----M-E---?--X------E-----XB-B|Xo-----E--------B---------T?Bo-----|E--|-----Xo--?-TE--T-------X--?B---M---?-|E--X--T-??-ET--E-T-X-?--|--------Xf|
-M-----M--?-o----ooo----X?XTBE-M----BX--oB----BE?--BB--X-BX-|--T-o-X-M-E--|TX--o---|--EM?---------|-M---BE|M|---X-EX-------|-----MEBE-T----E-o--E--M-o----X---B--------?--------T?-E--T--T-MB---T-M-M|f-
--o-X---|--M--B-M--o---E|---o--|----|--o--MT-----o-T-------T-MM--T-----X---|-----|-o|-T--B----------M-B|Mo--BB-B---?XX|-------T---B------|o--o-|-----o?------E-XXo|?-TX-T--M---E--E??-T--B-------|--|-fM
-M----oX--TMM--------B-X---|o?-------o-E-------EBo---M---E-ET-?TM-?--?oBB---------MT?--M---B----Mo----MXT-------o---M--------M----M---o---?---|-T-?X-M--B-|----?---B--o---|-M------MooE-------|--?-M-TfB
---o-T-X-E-E-EM--E----------B|-----E-M|-T----XBX-X-o-----|oM-----XM-o|Bo--oE-|?--E---?|-B----EB-o---------MM------------B---MT--X----T-E--M--TM----X|-M----T-B|----XMo-?-X---B---E-BMT|---|T-?----?---fo
-|------o--MX-|B------E--TXM?-B--o-|B--TE----M-----|----oMo---o-B----|E|--B----?-XME?-?-|----T-------M-E---o-M----------E-EToX----B--EBX---T---T---T--------E-----|---||?-?---o----X----E--X--T--MX-MofM
m------Bo-MM?----Mo-T---M-E--|XEE---T---?TM---T---M---TX------T---o---XB--?TT-M--E--X-----B-BEE--?-E-BT-BM-T-E--------Eo---------ME----T-M--M-X-----E--MM-|--|----T--------T|-----?--T----o--T--T?X---MB
XXXXXXXXXXXXXXXXXXXXXXXXXXXXXXXXXXXXXXXXXXXXXXXXXXXXXXXXXXXXXXXXXXXXXXXXXXXXXXXXXXXXXXXXXXXXXXXXXXXXXXXXXXXXXXXXXXXXXXXXXXXXXXXXXXXXXXXXXXXXXXXXXXXXXXXXXXXXXXXXXXXXXXXXXXXXXXXXXXXXXXXXXXXXXXXXXXXXXXXX
