---------o----T--------------B-----T-?------o-----------------o-----E--------|--E----oX-B?-----------|--------------T--------------T-----o-----B-o----------------?|---o--X----B------------------------
----T--------X|----------|--------T------------X---E-------------oE---?--o----------o-----|----M---------|----?-----B----------------M-M----o----M-o----?---------BT---|----T-M--o------E---------------
--------o--E-T---X----B--EX--|--M--|-------------------B---?------------------------------E-----?---?----------o-----B----|-------T---------------o---T--|----M--|------X--?---M-X---?--|--------X-----?
----------M----B-----T-T-----|------------o--------------------o----|--------------T---------X------------------B----------MT------------------B?---E-??E-M-------X--o-?--T-----T----?------------|----T
-----?----------T-E------------?-------------B|Bo-------------XM-----?--o---------X---------------o----------------E--------?---MM-ooo----T-----|o-----------?-?------B-TBE----X-o-|-B-----B-----------o
----------|------E-----X----------o--------T-----------o---------T------------------------T-----------B-------o---|---M----M--------------|-E---T--------------M---M-M-----B-------o------?--------o---E
-|----------|------|-|--------------M--------------?--B----------T--B---E-----|--o------|----E------------E-B-o-----|B-T----T---------B---o-------------X-----------E---------T--?-----------B----T----o
-----------B-|---E-----T--------T-----------?----|-E-------------|--o------------------T---T--o---------X-?-----------------------E?B-----------------T?-----------M--E----o-------E--M---o-|--|------vM
---BE-E|--XE---X-E-MB-o--??-----EM-----?-------|--oXB---|---E-o--oB---|M-MEo-B?B---E-----?-?EE--MX|E--M---T---BM-----TT---?----T---?--B-o|T----B--E?--X--E----o---?---------X|--B-o--------T--Mo---B-BfB
-------B-EXTB-o-|X------X--?M?-T-X|-------T---M--B---?---M-X-oo-|To|-oT---T-|--?---o----BE---TT--M-----?-X-----?--M--?-|-TM---B-M--?-E-M-------oM----?-----M-o-T-?---E---?-------?------BT--------|-E-fT
-----T-EB--M-?-o----T-||M-?----o----XE-E-X-----TB------B----XE--o--B--M-?----E--?-------B|---E--------|--T--Eo?--E-E-----E--M---o--T--?EBX|--o-----X----M--?-?|-----X---T-|--o--M--B--T|B?|X-X-E----B-f-
-o-ETo--E----T-B-M-XMM---?|oB---E-----?B-MTM-T----BT----|--X-XE-----EB--XB---T---------------o-TB-----E-?|--------BE-BB-?--MB?--E-X--E-?-oM-TE--MB----o|---o----------B-B-B-B-E--E----T------o---E-ooEf|
--B----M--T-----|BTBM----o|T------X--B-MBE------EX-|-E-B|X--------B--B-------X----------|---?---?M--E---|-|-?-------M--B--M-B------oE-B-----T-----B--Xo---X-?---M----o---|-ET--?---o-----|---T-B--?---f-
-|?o|XE-?--------?----o-oB-X-----MM----X------o-X--X-M----X-oE-EX-----o----------?-|-------E?-|-X--------E?-B|-----|---|-M?--o-?TB?-------B-----Mo----o---|E-|-M-X---|--|-M----BE-----o|B----|o--?-|-Mf|
mT-B-X--MB------B|?-B-M-B-TMEoE--MX---E----|M-XM?-X-----------B--BX-Eo----M-E-Bo?-oX-X---o---?-B--|-E?--|-X--E-??oXB-E-E---B--X-----?------BB----------B--M-E------T---o-?-|X--o--|--E---|?o?-?--E---o|?
XXXXXXXXXXXXXXXXXXXXXXXXXXXXXXXXXXXXXXXXXXXXXXXXXXXXXXXXXXXXXXXXXXXXXXXXXXXXXXXXXXXXXXXXXXXXXXXXXXXXXXXXXXXXXXXXXXXXXXXXXXXXXXXXXXXXXXXXXXXXXXXXXXXXXXXXXXXXXXXXXXXXXXXXXXXXXXXXXXXXXXXXXXXXXXXXXXXXXXXX
