---|-----------X--X---o-------|----E-o----|--M----------------EX--E-------X---------o-------------o--?----X------------------B-----------M----?----------X-----M-TX?----B----|---M--|-----B------------|
--------------------|---------T--------|-o-----o-------|--------------?------------?----o------?-------oT---------------?--B---|--------X------E----?-M--o--o-------------oE---B--M--------------B-----X
-------X---E--o---------------------o---|X-----------B---------T-----?-----M-X--T-----M----o----------?--o----E-|------------B----------|--?--------------T--------------------o--------------X------?-B
-M------E---------------T------T------T--------|--?------??--M------------T---X----------M----------------T--------------B--|------X------B-o------o------M--------------------------------o-o-------T--
-----T-------------E-M--B-----B------------------X-------------B--o----|-------------B---B--X---T-T-------------o--------|------------TB-----X---------|-----TT-----------------T-----------|----------T
----------M----o----------T---------B---Eo----------B------?-----|M------M--X--------X------------------?-----E---------X--X--------|----E---------E--XM----T--------------E----?---------o----B----o--X
-------------B---------E-------EB|------T------|------E----------------------------B-----T|--o---T--------o--X-----T-----o----T---------T--------B----X------o----B---X------?-E-----|-----|--X--------o
-----------------------------------EB---|------MT-X------------M-T-------|------E--------------E-----------------------------E------M---XE--------M--M---|--------M-------o--------B--------MB-T--o---vM
---T?---E--X------?-?T--oX-M-TT------|E--Eo-X---o----T-o--T-?-XB|E--E----M-EX-X--T-X-TT--TXX--M-E?-TX-----T-M--T-T|-------M--E|T---oo---o-X-----B--------o-XX----?T-E-|-||-?--------E-B-XE--M------XM-fo
-----Eo--T------B--X--T?-----EE----B-E-M-E-----T-Bo|E--|---E---X-o-E-?----------B--M----X---M--|-?M-T-||-----MT-o--?|X--M---T--TT--B-oMMT----o?----------o---B--T---M----M|---B---B-------?----o-TXB--fB
-T----|--E--EME----o--X-BB-------|--E?TT----MT---||-o--M-?-M?||------|---T--M-----MT-o-----X-|---M------MBXT-E-B--X|------B----------E------|----MM--|-X----M-?-X-----???T-----M-T--TE-B--M-o-|--??---fT
-?----BX-T--M--?-E--TE---EM-B?X-o--M-|--B--TB-|--E--TEXM--B?-XBo--||-?----T-----??--M----T-T?-------E-BT-----|---MTT-T-T--?o-----|---X---?-o---?--E--B?----|XB-?BM-B--M---T??-B|------XX--TT--BE--?---fo
--|--X-----Xo-T-BX----XB|M-ME---|-EB-----XE|-----X-?-M-----EE-?X-o-TT-----E-------E--o-B-M---T---o---o--X--o-T-M-??--o-B----X--Xo--EEM-X|----T--T--X-o-B|To-B?E-----B-----Bo--E-o--T--X---B---oo------fM
----------------?---M-Bo-XTE-------|--o?-?-T---------o-TX--|T-|T---M----T-M--MTT-------T---------XTo---o?o-------BT?-??---------X-M-|-o-X?-MME-------------------B-------X?-|M------B--EX?B---T--XX-|?fo
m-XBo-----BMX?M-?-M-----|TX--B---E----?----?XEX----B----MB-X---?XE-|MT--EEB-o-?----o---?-o---|--B-XB----oE---------B-T---Eo--X-----MM--??XXE-||M---B-M----X---M----M-T--|T-B--ET---|X?-?-X-M-----T-X-B-o
XXXXXXXXXXXXXXXXXXXXXXXXXXXXXXXXXXXXXXXXXXXXXXXXXXXXXXXXXXXXXXXXXXXXXXXXXXXXXXXXXXXXXXXXXXXXXXXXXXXXXXXXXXXXXXXXXXXXXXXXXXXXXXXXXXXXXXXXXXXXXXXXXXXXXXXXXXXXXXXXXXXXXXXXXXXXXXXXXXXXXXXXXXXXXXXXXXXXXXXX
