----------------------------------------------------------------------------------------X---------------------------------------------------------------------------------------------------------------
--------------------------------------------------------------------------------------------------------------------------------------------------------------------------------------------------------
-----------------------------------o-------------------------------------------------------------------------------------------------------------------------------------------------------------?------
-------------------------------M---------------------------XXX---------M--------------------------------------------------------------------------------------------------------------------------------
--------------------------------------------?------------------------T----------------------------------------------------------------------------------------------------------------------------------
-------------------------------------BoBBBBBMBBBBBBB-----------------|----------------------------------------------------------------------------------------------------------------------------------
----------------M----------------------------M------------------o----|----------------------------------------------------------------------------------------------------------------------------------
-----------------------------o---------------------------------------|------T-------------------M-----------T------------------------------------------------------------------------------------------v
-----T----------T--------------B-------------------------------------|------|-------------------------------|------------------------------------------------------------------------------------------f
-----|----------|----------------------------------------------------|----T-|-------------------------------|------------------------------------------------------------------------------------------f
-----|----------|-------------B---------------B----------------------|----|-|-------------------------------|------------------------------------------------------------------------------------------f
-----|----------|-------------T----------------????????--------------|----|-|-------------------------------|------------------------------------------------------------------------------------------f
--T--|----------|-------------|----------------------X---------------|---?|-|-------------------------------|---------------T--------------------------------------------------------------------------f
--|--|--?-o-----|-----------T-|-??-------------------XX--------------|----|-|-------------------------------|---------------|--------------------------------------------------------------------------f
m-|XX|---?------|-----------|-|------E---------------XXX--E----------|----|-|-------------E-----------------|-----E-----E---|--------X-----------------------------------------------------------------X
XX|XX|XXXX?XXX--|-XXXXXXXXXX|X|XX------XXXXXXXXXXXXXXXXXXXXXXXXXX--XX|XXXX|X|XXXXXXXXXXXBBXXXMXXXXXXXXXXXXXX|XXXXXXXXXXXXXXX|XXXXXXXXXXXXXXXXXXXXXXXXXXXX-XXXXXXXXXX-----XXXXXXXXXXXXXXXXXXXXXXXXXXXXXXX
