----------E----E----------------------?----------?------------------------------------X--------------------B-o----E--------------B----oX---M----EM--B-E------X-----------?o------------------E-?-----M--
--------------E----------E------M-----------------------?----B-----X---------------------?----M---------------o----------------------------------B-----------E-M---M--?-B----?--------o----B------------
----X---o---------------------E--------B--------E-----------o------------X-?-----------------o-------o---------------?--X-------------E-M-X---B-E---------------------------------------------------B---
--T---X-------------------------------B----M--?o----MB---X--X------BB---------X-?-------X-B--------------------o--X--MB---E-------E--------------E-----------E--E--o----------?--------B----BoB--B----M-
-------?-----B------------------------------?------------------E---X?-X----E-------------?-------------o-------?-o-----B---?---E--E--E--------B-----------------------------------------M---------------
--X--------o--------X----------------------------------------o-------------?---------------------------------------------------------M-------B--E-----------B--------------E------E-o-X-----------------
------?--X----------------BE----B-E---?--o----?-----M-------------------?-----X---------------------?------------------------o------------------------o-----B---o---M---------------X----------?---o----
-------------------M---o-------B------?-------?--------?----BE-------------------B-----M------------X--M---B-----o------------------E--------X-----------------------M-------------E-X--------------?-v-
-XE-------?-EE------------------o--EBB--E--EM--E------X-M---E---M-----?XE---BM--E----------------EX----X-E-E--------X-E-B---B---X--EM-----M------E-X----XM-M-------------?----X--X-M---B-E-B-E--o-----f-
---oB--oM---EE-M-?--B-o-B-M-M--M--------?----o?---?-X-------oB-o---X-----E----B-E----------EM------M--?-B------------------B--M--?o-Bo----------X-X-M-----X-o--X-MMM----?EB---------oB--?--o---T------f-
-o---o-T-------E--M--?M----E---E-----M--?---------ME----XB-ME---o---------T--BM--M-oE----------X--E---ME------M--TX--------M-------M-XBE-?------E--o---EM----EoM-?B-o--oo--?oE-E---T-M-E-BE-?-----M-?-f-
-X---------o------B----o-B---o--?----MB------Eo---B---------E?XBMM-X-M-----Mo--M------E----M-o-EB--o-------oBBB-E-X-B-----X---?---BE------M-o-Xo---E--M-E----?---B--M----B----B-MBX-----B----o---X----f-
-----M--X----BB------------E-ME--X-----B---------BB--M--X-E?------E-E-o-B-X--oo--?-?---EE----M-E-----X--oB--?---Bo--X-B-----B--B---------------EoEB--------B-Bo----M--X---X------?--?---X----M---B----f-
-E----?------E-----T----------B----B---o-MMM-o-B-T--E---o---EM--M---T---T-----E?-E-B--E--E-XB--B------M-o-MEX----o--M---B--TT--------B-o--oX---M-------X---o--BM---M-------X--------B----Mo?o----M--T-f-
m-|--?----?-T-BXX--|-------M--BM---T--E?-||TE-|B-|MT---M-B?X--|----E|--||---T----E?|---BB-----B------|-B----T--------X--M--||--?--B-|--B----E-E|---M-TM---------|--oo---M------M-T-T---|----?-----?-|-f-
XXXXXXXXXXXXXXXXXXXXXXXXXXXXXXXXXXXXXXXXXXXXXXXXXXXXXXXXXXXXXXXXXXXXXXXXXXXXXXXXXXXXXXXXXXXXXXXXXXXXXXXXXXXXXXXXXXXXXXXXXXXXXXXXXXXXXXXXXXXXXXXXXXXXXXXXXXXXXXXXXXXXXXXXXXXXXXXXXXXXXXXXXXXXXXXXXXXXXXXX
