--------------------------------------------------------------------------------------------------------------------------------------------------------------------------------------------------------
--------------------------------------------------------------------------------------------------------------------------------------------------------------------------------------------------------
--------------------------------------------------------------------------------------------------------------------------------------------------------------------------------------------------------
------------------------------------------T-------------------------------------------------------------------------------------------------------------------------------------------------------------
------------------------------------------|-------------------------------------------------------------------------------------------------------------------------------------------------------------
------------------------------------------|-------------------------------------------------------------------------------------------------------------------------------------------------------------
------------------------------------------|---------------------------------------------------------------------------------------------------------------XXX-------------------------------------------
------------------------------------------|--------------------------------------------------------------------------??--------------------------------------------------------------------------------v
------------------------------------------|------------------------------------------------------------------------------------------------------------------------------------------------------------f
------------------------------------------|------------------------------------------------------------------------------------------------------------------------------------------------------------f
------------------------------------------|---------------------M-------------------------------------X-------------T----------------------------------------------------------------------------------f
-----------------------------------X------|-----------------------------------------------------------XX------------|----------------------------------------------------------------------------------f
-----------------------------------XX-----|-----------------------------------------------------------XXX-----------|----------------------------------------------------------------------------------f
-----------------------------------XXX----|-----------------------------------------------------------XXXX----X-----|----------------------------------------------------------------------------------f
m----------------------------------XXXX--B|-----------------------------------------------------------XXXXX---XX----|----------------------------------------------------------------------------------X
XXXXXXXXXXXXXXXXXXXXXXXXXXXXXXXXXXXXXXXXXX|XXXXXXXXXXXXXXXXXXXXXXXXXXXXXXXXXXXXXXXXXXXXXXXXXXXXXXXXXXXXXXXXXXXXXXXXX|XXXXXXXXXXXXXXXXXXXXXXXXXXXXXXXXXXXXXXXXXXXXXXXXXXXXXXXXXXXXXXXXXXXXXXXXXXXXXXXXXXX
