--X-----?-------------o-M--o?--M--------E------MX-----------|---------------|-------B-o--|B-----------|------------------------E-|-o---o---XE-------M-------o-T---EB---T---o-------E---X-----------B---?
---------X-B-----|---?---X--------------M---------------------?-E------------?-------------o-?----o-------?--B----B-----|-------E--------X--------------X--M-----E---------------|--X------------------o
-------M-----T-------B----?-M--M---|----M-----------B-B-----------T----E------------M--------------------B----|---------------------------------------M------------?----M---?----------o--?T------------
---o-----o-------X-----E----E--------------------o-----E--|-----MoT---|-E---------?--------B---B---------EB----E------B--M----?---?------|-----------------------oE--------------?---M-----------E-----E
---E---T-B----M---E----o------------------EX-----------------------------oB---|B-----X----X-------|-----MM-E-T--M----|--|-----------M-----------------------M---------------------EE----|--------------?
-------------T-|-E--T------------------E----------?-----?---o-------o-------B----EX-B-------X--?--T-----------------------M------E-?-------o------oET--X---X------|------------B-E----M----------X-----o
-------------M-----------------|-------X--M-E??-----E--o|------|-X--|------------o--------------|B-|----------?------------------T---------X-----o--B-----XT---E---|E---MT-----B---|B-----------?---|--?
---M---------E-----T-X--o--------M------X--B--------?--E--o-----|---T--o----?------------|-----|T-----|---X-?---|-|---------------------XoB------------------------------|X----MX|-----T-----|-------BvE
-|--------oT-T??--?--X---|T-||?-??-|B----o--X-----M-----?--?-X--?--E-|M-E---o----B---|-T-|oEB------X-M--M---M-------MEEoET|-EX--?o----M--M-M?T-?-X?o--------|-----T-M-oMB-?------------oB---ETX----X-XfB
-B-|-M----M--?-------o---B--M--M-?-----B-X-X-B---Xo-TT|-o?------M-|-------E|--|--?--o|-MX-ET----E-ET----M---X---M---|XMX-----X-----E-XM---?T---?-----|?B--oTETT---?|X--o-T--|------E-|-----T-----EX---f?
-TM----M------B---?---TX----BM-------|o---BT-TB---M-|T--E-----BE--M---?MX------E--?--M-|-X|-----X|-||--o--|--?-M-BoB----X---M-----ME-X--o-BE--EMoM-E---------T-ME-TTB-MXXT-B----o--?---------X----B--?fX
------TT-MX--Xo--o-----?----B|-|-M-T?M----|?--X-oE------E----------E?M-----|--?o-MM-?|-Xo-X---X|M---X----M-----T--??-----B-X-o------T---------TB------o??|----||--M-E-?----oT?-ET-?-M-?o-B--E-X-X-B-o-f|
-E-----M-B----XX-o--?-?T---oooM-?--|-------T-M---------X--M-----M--E|E------B-------E-----T---M-o-?-E|-o--o-T-|--??---------------E----EE-----B-|T--M|-B-M?XT|---B-T------E-BXT-|--B----EX--M--------ofo
-|XXo--?-o----oB-X----X---M|-----M----?-T--E-------|-B---|-??-M--o?------X--E-EX-------E-?E--B?|B-T-B-ME-----X-?M--?o-M--E-BE-B-oo--|--M-----BXX--T-E-T--E-|T|--E-|-XEM-M-|-TE--B--EB---T-B--BBE-B-B--f|
mo---E--XM----BM--M--------|---?--E--B---XB--E-X-E---MT--EEoT|--M----|-oE|B|--?---M--oX-o----EEET---E---B----X----E--T--TB-TE--TX---|-----E-E--XX-BB---------B?-------E---|---X-XMoEo-?-B-----BM---TM?EM
XXXXXXXXXXXXXXXXXXXXXXXXXXXXXXXXXXXXXXXXXXXXXXXXXXXXXXXXXXXXXXXXXXXXXXXXXXXXXXXXXXXXXXXXXXXXXXXXXXXXXXXXXXXXXXXXXXXXXXXXXXXXXXXXXXXXXXXXXXXXXXXXXXXXXXXXXXXXXXXXXXXXXXXXXXXXXXXXXXXXXXXXXXXXXXXXXXXXXXXX
