------------E|------o---?---X-------------|-------X-------------T------|-------------------E-----T--|-|-T----M--------?-------XM-?------T--M-----X----------------M--------?---------------------------E
--E-------?--------?TE--E-----------|-----B-B---------|------?-------|---|-----------T-------MB-M------?-------?----------?----------BB------------E-|--B--E--M---------E-?-X-|----|----------------B--M
------T-||-X----------------------------?|--------------X---------M-|--------------X----o------XB----B----------------|-----------M-------M----------T-?X--B-------T-----TB-B--oB-M---E--------------M-M
---?---X------|----------M----T-----------B---------------------------------T--------E--M--------------------------o-----T---E-----M----T-----?---E-------o----------------------------------B---------|
-----------?---B------E-X---------------B--------B--X------------------E---|--?-------?-M-T----------------------o-----M------o-------T--?--------XM---------T--o-----BB?-----------E------------------|
--------------M-XX---------------?------|------------------B--------------------------------------B-|----T------o------T------|---------------M----B-------E----------X-------|--E-----M---------X-E---?
--------------E---------M-----------------------------------------------E-------BM---------M----E-?-o----------------T--M-----------o-E-X--X-----------E-T-------T-----------------o--X------------T---T
--?-------BT-----------|--------------------?-------B----------------------------|----------M--T-o----------?------------------X--------------M-M--------T---M----------------T---T----?------|-------v|
-B-o|M|M----o?|--M-T-----T-M--|-B-B---?-M---|-M-T--XM|o--X-BE-o?--X--o-----EB-|-X--E-M-?--E|------?-XE-----T-E--B--oM-MT--------B------B---X|-----------|-o--X--------?oX--E--EM--B-|---XBX?B-----M--Mfo
-|-|M?Xo---oBE-------E?--XX-X|-|B-T---T?------EM---B---?-E-|------B--oM-M-M---?M--B-E----o-X-|o---E-X-B-XXT?--------B---?|ME---o------oM--E-M---|---|------MMB|--M---o----E-E---B--X-M?---E-------E---f|
-?---T--|-EM-?--X--------oo--------TM---?--o-T---oX?-|---?-T--T-T---Mo---?---M-----X-E---B--T--------|----B-------BE--o--X-----------oT--oEE?-T----o-?--M?---M|-?-M---T-?T--B-----EE--T---?--?----X---fT
---XM??-M--EX----X-X---|--B--|----|-M|M--?-----ET-----oM-?--X----E--B---?--|MBo----?T--T-o-|--------M--XT----T--M----M----B-X-MB------XE-X--o-X---XB----TE-T---|EMB----o?-E--XT-B--|E---?---M|E---TX--f?
--EE-|----M--B--|--B--E--X--?o------o---B---X|X-M--M-B---BT|-----?B-Xo-EM-E--T------M--E--E---B--------|-|--T-o-------?-oX-------TT-|X----|?-B--B-B-----T------M-X-XB||E-X--?--oXX------B-----|?---B--fM
----M--|o--T-?-M|-ME--B?--T---------M--?---E-----E----B--BX-M---TX------B--ME---||-X--T-To-M?-B------B--o----??B--|TEX-o--oXM-------B-?-BM?--oXB----M-T-X---?--o-|--E----T--o-----M--|--?----B--B|?-B-fE
mT--ToTE----T-B-T?--E---o-E--oB-o--M---oM---M-M-M?-T------X----E--E--BT-T-??o----ME-o----M-----M|B----X-|-T---XM----B---?-B|------------T-M-T|-B--o----EB--T--E--|?E--B|?-XB--E-T-?|T-----?E-?-|?--?--TE
XXXXXXXXXXXXXXXXXXXXXXXXXXXXXXXXXXXXXXXXXXXXXXXXXXXXXXXXXXXXXXXXXXXXXXXXXXXXXXXXXXXXXXXXXXXXXXXXXXXXXXXXXXXXXXXXXXXXXXXXXXXXXXXXXXXXXXXXXXXXXXXXXXXXXXXXXXXXXXXXXXXXXXXXXXXXXXXXXXXXXXXXXXXXXXXXXXXXXXXX
