-------|E-M---E-----------T----M-----M-------X----?-B-----M-|-o-X-----B--------------X---------o----------------?-------o-T----T--o---------?-----B----M------------E--M-----------M----------B--------|
---X---X---B-------------------o--o----------M-o-----T--oX-X--X----------o-M-----------B---------------------B-T-----------|-----------M-X----|--------?-B---X-------------------------o-|--------M?---T
-------------------------------M---oMo-----------------o---------E-------T--------EB-----E---o?----------M--M----------?---M-o---------------T---------------X---|----?X-o----------E----------------|-X
------------X-----------------Xo----|------|--T--|---M---------------------|--B------------T-|-----------------|-T--B-----------------------------T|-------o---------------------------------------|-|-E
-----T------------T----------------------X------E-------X---o--T---M---X--T-|-----E----------------||M------------E--E--T---?E---------------------T---T-----E-oT------?-|----------------?--X-------|-X
-----------MT----T-B-?E---M--o---------E-------T-B----?---------MB-------Bo--------M----------M------------------T---------|----|--o-------------------------|---E---T-B----------------|---------------
-------------E--B-------------------E-------------------E-----------ME------X---------B-------o-?---------X---------------------------o-----E-------B-------------------o--T--M---X-------o-|--E-------o
---------B---?------M-B----------------B----|------------------E|-----o------?---X----------T-BB---M-------|-------|-----ET--MT--T----------X-------TM-------------------?------------B------------o-XvM
---M-Eo-?--T-----E----?T|o-------?--E-T----X-T----X-?-TE---M---M?--?----oBM-|--?---o---M-?---?-T----T-X---E?-??o?-M---T-|-----M----o--E-|X---T---X-M|X-EX-----?X---M--X--B-|-?-X-------------?-B---E-|fX
-----|-o?---?------------B-|-----oTB-X---TT---X-E-------------?X-o---|o||-T-XB-T-TM|E-o------|-T-o--o-?----E-o--M-----B------?M-EB--XT------B-?---E-||-M-T--XoXXB----X?--BT------MTXX-B-|X-T|--M------fT
----M--MTM---XT-----E-M?-T-T-X?B----B-Bo----X-T-?--?---B--T------------oE--B--?------ooT-o-X--------X---?----BE-B---|---o-E?-o-B?|--X-X-X|--o---T--|M--o----o---o-T|T?B-T-?----M---M---TTM--|X----EM--fE
-----X--B--oX-o-BT----M---XB--B-|-T|M----?|M---T-|---oBBEEEoMM--|E-BB---T--oB-TX------T----|oE-E-B-------BBE-|-?B-o----o--M----B-----Eo------B-----o-----?X------o--M--EX---T--T-X-XX-T?--|-?oE----|oof?
-ME---------X--B-E-XB-|o--TT--|--o-XE-X--------------TX--------X-?--?-------T?-------o-----|-E-B-----E--E--?X-------X-Xo--M-X-T-E-EX-?T----M---?-Mo-T---?|--------o--oM-T-|---BX---ME----X?|TTo|XE----fM
---M-X-------EB---X------T-|?--BX---EEM-T-TT-E-----?T?--X--X-?-MB--T----?----M-?---M-E--o-------E--|------EX---o--|---------E--MX--------XBE|---oT|--E-------oX-|--MM-oB-TX-------TX-E-|--X--X-EBE-BE-f?
m----oB-X---B-------M----------oM---X-?---o---E-------M--o--?-MT---X--B------oX|M--X--------E-----X--BEBX--X--M---?-----MTX------E-----X-BX---?o?-Mo--B--o--T--TE--MT--TT-------B-------o----?--E?--?---
XXXXXXXXXXXXXXXXXXXXXXXXXXXXXXXXXXXXXXXXXXXXXXXXXXXXXXXXXXXXXXXXXXXXXXXXXXXXXXXXXXXXXXXXXXXXXXXXXXXXXXXXXXXXXXXXXXXXXXXXXXXXXXXXXXXXXXXXXXXXXXXXXXXXXXXXXXXXXXXXXXXXXXXXXXXXXXXXXXXXXXXXXXXXXXXXXXXXXXXX
