--------------o------------------------------------------o-------E----------------------?----------B------------?----------M---E-?----------------------------------------------------?-----------------
------------------------------E-------------------M---E--------o--------------------M-------E------?-------------------o------------E-------o---------------------------o--M----------------------------
---------------o---B-----------------------?---------------------------------------------------------------------o--------------------------------------------------------------------B----M-----B-M----
--------------------------------------?------?------------M-----M--------------------------B-----BM-------------?M-----------------?-----------o-------------------------------------M----E-------------
---------------------E--E--------------o----------------------------------------------o------------------------------------------------M-----------o--------M----?-B---B------------o-------------------
------------------------------E--B--------------------E------E--B---------o-----------E--------------------------?---B----------------------------o?----------------E--------------------B--------------
---------------o---M-?------------------------------------------------------B----------------------------?-----------------------------------------------E--B------?--------------------o-------o-------
---------------o----E---------------------------?-BB-----------------E---------------------o----------------o-E------------------E-------------E-----------o-------B-----------------?---------------E-v
-o-----------------o---------------------------?------------------------E-------B------B-----------------E------------------------M------B-----------o-------B------------B------E---?-----------------f
---------o-----------------------o-------------o------------?---------B--------------------------------------------o------------------M----------------------B----------B------?-------------M------o--f
---------------o-------B--------M----------------------------o------------------------M--------------------------?----------------------------------o------------E---------------------?---------------f
-------------M-----?---------o-----------------------------------------------T--------------------T-------------E-----------------------------------------------------------------------------E--------f
--o-----------------?----------------M------B----B---------------------------|------B-----M-------|---------------------------------B----?-------T----------M----o-------------B---M--------T----B-E---f
---T----TMT-T---T-T-T--T-----T-E-T-T-T---T-T-T-T---T------T--T-T-?T--T---T---|B--T-------T-T------|-T-M--T-T---T--T---T-------T-T--T--T--T-----TM|---T---T-----T----T---T---T--T-----T-T----|--T--T--T-f
m--|----|-|-|---|-|-|-M|----B|---|-|-|---|-|-|-|?--|?--o-?|--|-|--|--|---|---|---|B------|o|------|-|----|-|---|--|---|-------|-|--|--|--|-----|-|---|---|-----|-B--|---|---|--|-----|-|----|--|-E|--|-X
XXXXXXXXXXXXXXXXXXXXXXXXXXXXXXXXXXXXXXXXXXXXXXXXXXXXXXXXXXXXXXXXXXXXXXXXXXXXXXXXXXXXXXXXXXXXXXXXXXXXXXXXXXXXXXXXXXXXXXXXXXXXXXXXXXXXXXXXXXXXXXXXXXXXXXXXXXXXXXXXXXXXXXXXXXXXXXXXXXXXXXXXXXXXXXXXXXXXXXXX
