-----------------------------------------------------------------------------------------------------------------------------------------------------------------B--------------------------------------
--------------------------------------------------------------------------------------------------------------------------------------------------------------------------------------------------------
-----------------------------------------------------------------------------------------------------------------------------------------------------------------------------------------------------B--
-----------------------------------------------------------------------------------------------------------X--------------------------------------------------------------------------------------------
--------------------------------------------------------------------------------------------------------------------------------------------------------------------------------------------------------
--------------------------------------------------------------------------------------------------------------------X-----------------------------------------------------------------------------------
--------------------------------------------------------------------------------------------------------------------XX---------------------------------------?------------------------------------------
-------------------------------------------------------------------------------------------------------T------------XXX-------------------------------------------------------------X------------------v
-----------------------------------------------------------------------------------------o-------------|----------o-XXXX-------------------------------------------------------------------------------f
-------------------------------------------------------------------------------------------------------|------------XXXXX-------------------------------------------------B----------------------T---?-f
-------------------------------------------------------------------------------------------------------|------------XXXXXX--------------T--------------------------------------------------------|-----f
---------------------------------------------B---------------------------------------------------------|------------XXXXXXX-------------|-----------------------M--------------------------------|-----f
-------------------------------------------------------------------------------------------------------|------------XXXXXXXX------------|--------------------------------------X-----------------|-----f
-------------------------------------------------------------------------------------------------------|------------XXXXXXXXX-----------|--------------------------------------XX----------------|-----f
m---------------------------------------------------------------------------------------?--------------|----X-------XXXXXXXXXX--E-------|-------E-------------------------E----XXX---------------|-----X
XXXXXXXXX-------XXXXXXXXXXXXXXXXXXXXXXXXXXXXXXXXXXXXXXXXXXXXXXXXoXXX--------XXXXXXXXXXXXXXXXXXXoXXXXXXX|XXXXXXXXXXXXXXXXXXXXXXXXoXXXXXXX|XXXXXXXXXXXXXXXXXX-----oXXX------XXX-XXXXX---X-XXXXXXXXX|XXXXXX
