----------------|------------ETT------?------B--------------BM-E----M---------------T--------------o---------?---M---------o------?---E----o-o----------------------------?---------E----------M--ET---X
-----------X-X--B------T--T--------------------|---------E--------o|-------B----|-----T---?------o--------?-M-----|------o|---X--------M-M--|---T--?X----o-----|--B---------?-------T--T-----------B---?
---?-M---?-----o--------E-----------?-----|-------------E--------B----|-----------|-T-------M--------------o--------|---T---B----------T-----|--|---EM------------------B-----------X----|-----------o-?
-B-M----|-----------X?---?-TX----X------B---------X--o-T-T-------T---------------------?----------?--?-------|---M---EM---EX-----------X----T-----E-----|--|--X--T-----E-o------------------M--M-----?--
---------|----|------M----T----X----------------------?----B------B|--E---E-------o?-----------|-------E--B|---?-T--------X--------B----X-------------B-------?-----E-B---T-o--X---?--|-------B----B----
--T--E-----------------X-T-----E-B---------o-|----X-----------------E----?------|-|------B-E--?---M-----------B-o---M----------M------------?-------------------------M--------------------------------|
--X-----B--------------?----XE-----------------------------------M-?------T-------------o------E-o----|---------o?------E-------?-----------------T--X---E|?-M-----XM-------------------|-----o-|------E
-----?o--------M--?------|---------X-X--------?---M---B----------------------|-----o---------------?-----B-BE--------M----X------M---------------o-|E----------?---E---?------T|-M-------------------?vB
-B-M----B---------X|---|-?EM-E|---?----M----E-E?----EBB---?|?-o?oX-T---B----E----E--M|--B----M--|-T-?---?M-TE---B-T--X-----?----T---|-XX--|------oM-|?----TT--?--B---|M--X--BB--o--|T-|-o?X-------o-X-f?
-o-XX??-M|-----B----E---?----TM-X------|-B?--E-M-|---E--------BoEB-B?--|---o?------|-----M-E-|T--o-X-|o-B-----EMT-T--MX?-|--Mo------------X--B-E-|o--B---EBEEM|X--E--X-o--E----TMMB-T---E--XMEo--B?|XMfB
--EBB--B-|-------X--X------|----o----X-?--oX-TX----oM---Eo---X--E--|-----B--E-T?-M-----|B--?---?--BM--X--T-o------B--B-XEM?MBo-E-XoX--TBE?T--E-To?X--------E---o---------ETE-|--?---oMX?-X---?--B--E-Bf?
------BMBXT-o-----T--?--M---o---E---E|------X--X-EoBo|-o-----EM-|-|--T-o-?---|-?--||--E---oT-----E-X----BXE--?E--T-----oXT-X---------B--?-----T---?-BM?--M--BE---|----o-|B-BT----T---X--XE?-|---o----Bfo
---------|-Xo--------|---TXMT-----?-ET|--T?|?M--|--|E-o-X|T|-B--B-?-BX---M--------TE---BM--o-|-Xo-?E-|-X-|-----B--o---o------------T--M----o?--oT-|-E--|MTBM---|-oX-M---o--X-?------oE-T-X-B--T--X-X-Ef?
-|-o-T-X-------T--|E-------T?-|-To-B------|oTM-|X-T-M--E--|-o------TM--X-B-M-M----M-----o--o-----TB-M-EX-??--BT--M|X-|------o-----B-----B?-oB|-?-?-E----------E----?-|----oBT-----?-E-o---MX---B--E---fE
m-TX----B?T-?-X----TX----------TB-----TE--?----X|M--|-T--M--T----BME-X----|--?---T----|----T-TE----TBT----?|-|BM------X--MM-T-----B-----?-X------T--E|-M---TE---E----MB-B?T----MB?--|To----B---------EX-
XXXXXXXXXXXXXXXXXXXXXXXXXXXXXXXXXXXXXXXXXXXXXXXXXXXXXXXXXXXXXXXXXXXXXXXXXXXXXXXXXXXXXXXXXXXXXXXXXXXXXXXXXXXXXXXXXXXXXXXXXXXXXXXXXXXXXXXXXXXXXXXXXXXXXXXXXXXXXXXXXXXXXXXXXXXXXXXXXXXXXXXXXXXXXXXXXXXXXXXX
