---------------------------------------------------------?----------------------------------------------------------------------------------------------------?--------------------X--------------------
-------------------------------------------------------------------------------------------------------------------------o------------------------------------------------------------------------------
-------------------------------------------------------------------------------------------------???----------------------------------------------------------------------------------------------o-----
---------------------------------------??B---------------------------------------------------------------B-----------------------------?-----------------------------------T----------------------------
-------------------?----------------X------------------------------------------------X-------------------------------------------------------------------------------------|----------------------------
---------------------o---------o--------o-------------------------------------------------------B------------------------------------------X---------T---------------------|----------------------------
-------------------------------------------------------------------------------------------------------------------------------------------XX--------|---------------------|--------------------------X-
------------------------------o-------------------------------------------------------------o----------B-----------------------------------XXX-------|--------T------------|--------------?-----------Xv
-----------------------------B----BT--------------------------------------------------------------------------T----------------------------XXXX------|--------|------------|--------------------------Xf
-----------------------------------|-------------------------------------?-------------------------XX---------|-----------------T-B----X---XXXXX-----|--------|------------|--------------------------Xf
-----------------------------------|-----------------------------------------------------o--------------------|-----------------|-----XX---XXXXXX----|--------|------------|------T-------------------Xf
-----------------------------------|-------------------------T-----------------------------B------------------|-----------------|----XXX---XXXXXXXX--|--------|---------BBB|BBBB--|----T--------------Xf
-----------------------------------|---------B--------------o|------------M-----------------B-----------------|-----------------|---XXXX---XXXXXXXX--|--------|------------|------|----|--------------Xf
-----------------------------------|-------T-----------------|------------------------------------------------|---------B-------|--XXXXX---XXXXXXXXX-|--------|--T---------|------|----|----X---------Xf
m-------------E--------------E-----|-------|---------E-------|----E------------------X-----E----E-------------|--E--------------|EXXXXXX---XXXXXXXXXX|--E-----|--|---E-----|------|E---|----XX-E-E--EEXX
XXXXXXXXXXXXX------XXXXXXXXXXXXXXXX|XXXXXXX|XXXXXXXXXXXXXXXXo|XXXXXXXXXXXXXXXX-------XXXXXXXBBBBBBB------XXXXX|-o--XX-----XXXXXX|XXXXXXX---XXXXXXXXXX|-----XXX|XX|XXXXXXXXX|XXXXXX|XXXX|XXXXXXXXXXXX--XX
