-----------?----E-----M---M----------M-----?-|------E-E------------T-----o-?---------------E--------------------------X--o---------------B-------T------------------?-----?--?--o----------------------?
-----|----E--M--B---------T----------T-------X-B-------M-----------?-------o----------------------o---------|-----------------|---M------------E---------------X|-----------E-----MB-------------------|
-------MM-|--T------------?-M---------------E------------ME----T-------|-------------------------?------------B-X------B?--T-----------------------|--B------------------------------------T-T---------E
---------E---o-----Xo?----X----B-o---B?---TM---T---------X------------------o---------B--------------------------B----------------B------T-----------------------------T-----?-oM---------?B-------B---o
-|--------o-------------o-o-|-----------B-M---B-o-X------E?----?E------X---M---------B------X------------o----------------M---------?Eo-T---B---------EE---?------------M-------B--------------M-M-----X
---E-------X-----------------B-------------T----o--B------B------?-------------E---T--E-To--M-------------------T--------------------B------?-T----------------o--?o-----------------E---------B----M--o
--------E----------------B-X-T---M--T-------?--oE---------------M--|-------?-------------|---X---------T----E---oM------------------------?T-?------------M---EEo---------------X--------------------X-X
--B---------|-----|--------------E------?-E-?----|------?------|------M|-------------?---------X--X-?---B-------------M--------------|----------?------------?---B--------------------------?------T--vM
-----?--o-?|BTX?-T-o--XMM|E----MBM-----T--|-|M?----|M---|--E----T-----X--B-E--oBB-B-M-|EX---|--o|TB|-B-?-oX------E--X---ET--|?-B--T|----M-Eoo------?-B?-X--TM---M-T-BX-------X|--B--T-----|----?-|----fX
--B-B-----------TB--------E----M----?-X----|--B-T--M-----M-BM--X-?|?---E-|o---?|-|-T------T--|--ToM--EE-------|------|T-TB-B-?o-X--TE-M----M--------M-||----?--MoB---E-----?-----BoXT--B---ooE-E-B-T--fB
-T-M-B-------B-X---o-?X----?B--T--o?---------XT-----T---X-EM--M------ToMEo|------T-o-E------?---B--XE-----|---------X-ME--M-T--B|------o---M---o----E-----------------|T---E?|-o-oMo------E-----o-----f|
-M---Mo----X---------T-o-------T-ooTT-oTB---M-M-----B----X--X--|-X--B-----B----?Xoo-|-------B---E-?-|-T?--------B|EoTEB---EB-E------?----?B--X--B---|-|-M-o-o----o--XT-oBT---M--?B-T-?---B----B|----T-fo
--M-------?MB-XE-X?---o--?|--o-|XX-|-B--EE-------X-B--TB--o-o------X-Mo---------B--?-|XX-?-|MX----X--E?o-X----o----T-?o-|-oT-----E--|E|-?-|---E---?B-----T|-E--?--o-To------B-EM|----M-X--||--?--To|o-fX
-|?--??--T------B---T-o--Bo--BM---|-oT---B-M-------o----X-?-o--ET-M---B--o-----?|--?-MX----ToTT-------TBo--TTo-EEX---E-?--------------?T---X---XX--o---XE?--ME--|MM-M---o-TE-T-B----o---Eo------|-----fM
mE-T--?EE--Mo------o---BM--------MEX------B--M-----o-X|-------X-M-----?----B-M|o----M--------B-Xo-----ET-T?-B------?|-o-E-EoBo--B---?-EB---o----X-M-X--Mo--M-------MX--BM-TM---X-E-T----------X------TET
XXXXXXXXXXXXXXXXXXXXXXXXXXXXXXXXXXXXXXXXXXXXXXXXXXXXXXXXXXXXXXXXXXXXXXXXXXXXXXXXXXXXXXXXXXXXXXXXXXXXXXXXXXXXXXXXXXXXXXXXXXXXXXXXXXXXXXXXXXXXXXXXXXXXXXXXXXXXXXXXXXXXXXXXXXXXXXXXXXXXXXXXXXXXXXXXXXXXXXXX
