------------------------------------????-------------------------------------??????----------------------------------------X?--------------------------------------o------------------------------o-----
------------------------------------------------X-----------------B--------XXXX---------------------------------------------?---------BBBBBB-------------------------M----------------------------------
--------------------------------------o-----------------------------------------------------------------------------------------------------------------------------------------------------------------
-----------------------M------------------------------------------------------------------------------------------------------------------------------------------BB-----T------------------------------
-------------------o-------------------------------------------------o------------------------------------------------------o------------T----T--------------------------|------------------------------
-----------------------------------------------------------------------------------------X--------------------------------------------o--|----|--------------------------|------------------------------
-----------------------X-----------------????????-----------------------------T-----o----XX----------------------?-----------------------|----|--------------------o-----|------------------------?????-
-----------X----------XX---------B--------------------------------------------|----------XXX--------------BBB----------o-------X---------|----|------X---?????--------BB-|-----------------------------v
--------------????---XXX------------------------------------------------------|--------o-XXXX---------------------X-----------XX------T-o|----|------XX------------------|-----------------------------f
--------------------XXXX------------????------X-------------------------------|----------XXXXX-------------------XX----------XXX------|--|----|------XXX-----------------|-----------------------------f
-------------------XXXXX------------------------------------------------------|----------XXXXXX-----------------XXX---------XXXX------|--|----|-T----XXXX----------------|-----------------------------f
------------------XXXXXX----------B-------------------------------------------|-T-----oX-XXXXXXX---------------XXXX--------XXXXX------|--|----|-|--XXXXXXX----B----------|-----------------------------f
-------XXXXX-----XXXXXXX-----------------------------------------------o---B--|-|---T-XX-XXXXXXXX-------------XXXXX-------XXXXXX------|--|----|-|----XXXXXX--------------|-------------T---------------f
----------------XXXXXXXX--------------------------------??????----------------|-|---|XXX-XXXXXXXXX--------?--XXXXXX------XXXXXXX-----o|--|----|-|-B--XXXXXXX-------------|-------------|---------------f
m--------E-----XXXXXXXXXE---------XEXXX--------------------X------E-X---------|-|E-E|XXX-XXXXXXXXXX---------XXXXXXX-----XXXXXXXX-----X|--|----|-|----XXXXXXXX------------|-E----------?|?E-------------X
XXXXXXX-------XXXXXXXXXX-----------------XXXXXXXXXXXXXXXXXXX?XX-----XXXXXXXXX-|X|--X|XXXXXXXXXXXXXXXXXXXXXXXXXXXXXXXXXXXXXXXXXXXXXXXXX|XX|XXXX|X|XXXXXXXXXXXXXXXXXXXXXX-X|----XXXXXXXXX|XXXXXXXXXXXXXXXX
