---------?-------------------B----M----------------o-----E-----------o--T--B-----X--------------------------M-----------M------M------------------B----------|o---------M----|--------B---|---B--T-----X
--------?-----------|-----?-------------M--------M--X------?-----|-X--------------------M?------?----TB---M-BX--------------------oE--?----B--------B-?------------------------------|-----?-----------T
--------X-------M---------------B?-----------X-------E----------------T------------TT-----M---o-----X--|-o--|-----------------T--------E--------T-------B-------------------------T--T--------------o--?
-----o-----------o-------------?--M---|----------B-------|--M----M------------------M----T---B-XT--T----E---E-----------M---o----?--?-----B-----o------o-----T--------------|------?------------?------X
--------------------------------X-T--E---o---------?--Eo-------------?---------B---------------T----?----------X-------BBX-M------|--B-----M---MX----X--------------------o----------------------E-----T
-----M|o----X-----M--o------T----B-------T-----------------------------|---TBE-------|------X-------T-------|------|---oo------T--?M---------X-----------?---T--------X------------o?------MM--MX------B
-------------------M--B-T---XX-E------------------T-B?-----------M-X----T--o-------|---M-|--E-E------------B-B---X---M---X---------X-------EE-------M--?---------E---------o-----------X---------------o
---T|-----------------------X-------B-------E---------B-----T----------------XM----B------------------?----------------|---?-?-----E-------------o-----------------------X-----E---------|---|--X-----vM
-E---?-------X--Mo?---T-------E?---T--ET-------EB-|-?X--------?---B-?---?-o--|-T----T---|----MEX-E-T-----?M?XM-------------|----?-X--|B--T--T|o-X-X---E--o------M|-X-o-?-X|--M-M-----o-To------M---E--fo
-------XT-T|-T|-M----M----Mo--T-----MTX---BBT-B-o---|----E---?--E-Bo--o--M---o?--------T--------o-----------?---?X-E--X-?--E-o--oo---X-B--|--|XoTX?--M-oT-o?|----M-------ToT--|-BX--M--|ET-B-T---M----fo
---?-X-X--X-oM-BX------X----T--|--T-----B----B---?---o|----|M--T-oM|-o-M-X--oMB----------|-----M------------X----?--------?M------M-M----?X-M--X|---o?--B----------EM|---o----XE--X--o?MMo---T----XTEEfo
-----X-|-----o--o--o------X------?X-?B---M-XB-----------M---o-X?-T-E-M-o-o?---T---T-X-----T-?-E---BT--o|XBXBBo-|-TTM----EX-E-oX--|--------To---X--X----X-----?--T----?---T-------?B-BXMTE--|------|---f|
-o-X--------?--------EEBT--M|M-E------B---|T-X----X--M-----------?o-o-XM---T----E---B-E-B---------E-X---o-TTBo---B----|BE----|?--------X------?-?-----E---------T-B--BE---E--oB?ME--oE----?BM------|B-fT
-X-?---ET-|-----X----B---B----o--E-----?ETBE---------TX-|-------?---|-ME-TBT--E------?---T--------X-------MM--BE-B---------?----------MT?---BM-E-oE-----BM-o---E-B-T-B-o--|--ToEo--XX|-------XoT----M-f?
m-------------B-o-----T-|------B-o|--B---EB-------TT-MoT--M--X---X-o-?ME-MX--o--Xo------E||--|X--B--ET-o-------E|---|T?-?-X-T----?-XE-----B?---M|To------o----B-TB-TEBTB--|BB?T-?Bo-----?M------?-----?o
XXXXXXXXXXXXXXXXXXXXXXXXXXXXXXXXXXXXXXXXXXXXXXXXXXXXXXXXXXXXXXXXXXXXXXXXXXXXXXXXXXXXXXXXXXXXXXXXXXXXXXXXXXXXXXXXXXXXXXXXXXXXXXXXXXXXXXXXXXXXXXXXXXXXXXXXXXXXXXXXXXXXXXXXXXXXXXXXXXXXXXXXXXXXXXXXXXXXXXXX
