----MX---|--B-XT-M--E-------------------------------------|--T----X-----X---|o----------------E-|-T--M-----------T----------M-------T------------o------------TET|-|------Mo----B--X-T--BB------T-E----o
-------T---T-------MEX---------M------o--------M-------o-----E---|B-------B---------T--E------o----------B------------?--------------------B---|------B---------------------T-----------------T-----B--o
---TX--o--E----M-----B-------------E----------M-----X----E--------------M-----oMM------T----?------|--------------------|---------o-----------------M---------o--------X-X-------X---EB----o---------|-E
----o-?|------------B----------Mo----M-|?---o-----------------------T-------------B----------------o------------------------B-?-------?-----------------X-?----------------Mo-------------o--o------T--X
---oT----E-T--|?-------B--X-----?---------B------T------------B---B---------E--------T----?----------------------------oE----|------X-EE---o--X------X----X----B-T---------B-----o---------XT-X-M------B
-o----------------BB-------o-------B------------o--M-----oE--------M---M------------------M--M-T--M----------------------------------E----T-----|---T-|--M-------------------B--?-|----------------X----
----------E--X-------------E----------------?-E------------|-o?XE------------------M-|---o-------?E----o----------T--T------?------?-------?-----X-------------M---------------?-------------T--o---T---
-----|--|Xo--E--?--------B------B-X--------B--?E------M------------------M------------T-E-|M---?--------XT-B-X-------------M--B-------------|--M-E----------------------------B--------M---X-------X--vX
--M-X-?-T--?-------?---X-oM--XM--X--|--?TE-----?---B|-----X----B---E-o-X-|------EB---M----o-----oo--M--EB--Bo--------o|-T--?--T-T-E----T--o-------?--B------?XEo-B---?--EE-E-----EX---|------E---|oM--fT
---o--?-o--X------BB----T--?X----M-M-E?B-X--B---|---|---X-------|-----|-X-X--M??-|--E-T--X?-|-----o|M------E|-------X---o-X----X--------?----|-B---?E|-o-|----?TEE---|---M---E---EBE---?-E----?--|E---f-
------o--o??-------|T--M----T----T--?-o------TEB-M-M-?-B-X-|XM-?ETT------M---------------B-?---M--T-?--EXT--E-B-----?--|-----E---BB-o-?-E-Eo-----?--T----E-XX-?--To-BM-T-M-------E--?E-----X-MX---o--?fT
-------BXT?--?---BE-----?|X------MX|o-E---E----o-BX---------M----EX--T|-B-Mo-o----E--|-E------E-T-----------X---oT--E---B-o-oB--X--MEB----E-Xo-MT|-|-----BoB------Bo------MB--|E--o-XB----------o-----fT
----E--X--E-T--M--T?--------T---X------|---o----------XE-XoT-|o--o----X----X-o-E-T-----BE----ET--------E--E-E-oBB|X--M-T----X-X----X-------|--oB-X-X--EXo---T|----E-??-|-T-o-X-TE|Eo-o----M-?X?BE-?|-EfM
--T-T-M-------o---?---M-----?--T-E------X|--o---X---B------E|-E--------BEEM--B-------X---|--------T-||-|---B------------o?------M-T-ET---EMMX------BX---|---|--------------EE---o----E---X----To----?EfB
mo-M--X--MM--E----|--------T|M--X--XT-o------B?-?X-Xo?--M---T-E-BT?-M-|BoB--|---E--M|--TE-|----oE|----B--|--X?-----------|--------TB----ooT------EB-M-ME|-o-------?EX--X-B--|-------|----B--E|X----|----
XXXXXXXXXXXXXXXXXXXXXXXXXXXXXXXXXXXXXXXXXXXXXXXXXXXXXXXXXXXXXXXXXXXXXXXXXXXXXXXXXXXXXXXXXXXXXXXXXXXXXXXXXXXXXXXXXXXXXXXXXXXXXXXXXXXXXXXXXXXXXXXXXXXXXXXXXXXXXXXXXXXXXXXXXXXXXXXXXXXXXXXXXXXXXXXXXXXXXXXX
