-----o----------------TE---------?----o---M-------------EM-----o-------B----|------E-|----------T-------o---X----------o---?o------o----E------X-B----Bo---------------BM---------------M--XM--T--------
-----o---|-----------------E--o-------|-----BE--?----------X----B-|--------X---?-------|--------E------------------------------------o-T-----------B---|--------------------B--T---|-------|-------?---X
--?----------B---B--------XX--------|---M-----|-M---------------o-------T------|--------o------B--X----------?-------------------------------------------------B-----B--E-E-------------o---------?----T
--B---o-|--o----M------|----------B-----M--------------oB-----E------E-----------------T--------|--|------------E----------MM|---B-M----BM--E---|-------------------------------B-------M----|-o-------o
--X-------------E----E-M----X-------o--T---TE--------?---B--------B-o--------?B-----o|----------X--|----------------|--------M--------?------------|---M----------M------------B-------TB---o-------X--X
--MX---M-B--------------B----------EX------------------T----M--------M------------|-T---|----M----------------------------X---|B--------------o----------------------|------??------------X-------?-X--|
-------|----------EB------B-?-----------|E---?|X-M-----------------?-------------T?E--------B------M----------E---o--E--B----------M-------B------?-----M?---|-------------B-----|-B-------------------|
--BX-------E---------TM---------o----M------------------------------oB-----------o-------T-------------------------------o-M--------o--?-------------------------------E------o----|----------------?-vX
-?----M---B-o-X-----X?-o|--?---|----|----?-X--T--|-X--B-M--|-E-B?-|T-?--?-----E--X-M---M-o-----M-X-----TBX-oE----X-E----?--?TM--E-T--|-----E-M--T-|M--|---?------XT-|-B-M--B-|o--TTo?-T------E-M-X-B--fT
---?---E-BX-?T-|-|-X--TBo-M------?---|oM-M--?|E-EB----BB-o|--T|-M--?o--T-M--B---E---B-B-M---?---------o--|--o-o-----o?--|?M-----E|M--T-TM-??-|B-B-o----o---o--T--M---BT--X----M?---??|-o--?T|---|---Xofo
---ET-?--oETET----|TM?--|------?---XE----M---M----T??-T-X---T--B-|?-|---M-MX---X----E---X|-?---?---o-|--o-Bo??B-XT--E--X---B-T--|M-BX-----|?---?---B---T--T----M-|?--o|--MME-----T|--X--||---o--BT--XMfT
-ME--B--o-MXo----o--B---?-X---------|--o--------|------B-EE?--X-o-X--------B---|X-?o-E-?-Xo-B-??-E---X--MTo---B--M-----E------o---M-oo--|-oE-M---XM|o----|-B-E|---|o---E---M-o-XT--?M--E--||o-----X--of-
-B--?---TB-o---oE---MMX--B-?--BXEX--ToBo-MM-E-|-------T-B-E-T-----?-E-------|?--EB|--E?---B-X?------------MTM-EX--X--o--B--o--|--------XM--E-MT---|----o---------o-X----B-------T?XB|TEX-B--------|M--f|
-------|--M--X--B--------B-M-To-XT---X-X|---M-|---M-----E--o-?B-B----M-TB------B---M---|T|--X|-----M?--o-oM-|o--B|-|ooX-?|----?X|-?----TX--o---T----EM--------TE--oETo--B---B----------------X-X-o--E-fo
m?-------M|X-?-X--EX---|---X---M-----B---o---T-----Eo?-oM-----------T-?-M-E-o|TT-M-E-T----X---XTM--X-B-M-M--TX--M?------?-XX---B?--E-T---T--o----o--T-----XX-T----o-MTE-|--|---B--MT--o-?Boo-X----?B----
XXXXXXXXXXXXXXXXXXXXXXXXXXXXXXXXXXXXXXXXXXXXXXXXXXXXXXXXXXXXXXXXXXXXXXXXXXXXXXXXXXXXXXXXXXXXXXXXXXXXXXXXXXXXXXXXXXXXXXXXXXXXXXXXXXXXXXXXXXXXXXXXXXXXXXXXXXXXXXXXXXXXXXXXXXXXXXXXXXXXXXXXXXXXXXXXXXXXXXXX
