-----------------------|---?----------M-----B---E---------------X----M---------------------------X----------XB-----?oB------E------------------M-------E----T------E----T--X--B--------T---------------M
--M------M-----------------------------|-------|B--------------X------------X--------T--T--B--?---E---------------------|-----o----------B----|----------------o-----oE-?---o-------------X------X-----|
-|E---M---|----|----------?-------------------------------o--EB-------T-------?--?----T-----TT-|M--?--?---M---------------|-----o-----------M----------------M------o----M-------|----E---|------------?
---E---------------E-----------------M---XE-B---?---?-----MX--------B-----------X--------------------?-----------------------------------E--X------------EX----E|--------------T-----?---X------B--E---T
--------?T--o-----T-M-----------------BX-----------------T---------------------o-----------B-?-------X------oB--o---T-MT---T--------|-o-------?------------------------B--------M---------------E-XX----
---------------?---------------------?o----|---M---|---B----M|-----M---|-------------M-------------------------T----------------------------------------B-X-------------?-----B--------B---B-----------M
---B--X--o-B--|-|---|------------------------B--|--------------?---------------------E--------------o------M--------------?---X--o----T---------------------T---|-M?-----M--?o---|----------|-------T--E
---------------------|----------------o-B-------------------------o-----------------|----------X---------T---M---|------------------?---X-B---|---------E|-----TE-T--?-----------E---------X------?-?-vB
---X-XT-|--E--XM-----------?-o---T--oT-?-|X-o|-------------M?-M--X----------E--?--?--?-----------XB----------|XXE---|-M-M-T----T-o-M----E-----|X|--o-------|-----X-?---E-B-?-?-XX-?-EX---B----X-----TMf-
----o---TX-E-B-TX-XE--E---X--X--|-----B--------TE-TB------M-----T---T-MX-T-T---T-?BBTE--BM--E-E--------M-T--BBo-E|----X-BXX--------?-B-XE---X----E--M?---M-X-MTo------E|----|---E---------T-X------E-ofE
-----o--BX-B--M----E---T---B-|T-B-E--E-X------o--?-BEX-----XB-Bo-T--------M----oE-|Bo-XB-------o--EoXTXXB-----o?-M-----X--B?X----M-T----TEX----|-----EE----B-M-MX---|BX-B-o-T---T-----XEo--oEo|M-X|T-MfM
----------?--To-T-----T-T-?-----|--o---B|T-|--|X--------?-MB--TTX-E--|--XT?-X|--E---ME----B--?-EXT|-?-X-T--|---E--------B-X-X-----X--|-----|------?--|MB----BM-?----E-?o-o-M--XB--oE---o-------?----M-fB
-B-X?-||------o------M---M-XTM--B-----|--X------X------?ME-----B--?--?M---TB--X|--XB|T------|-X------T-------|-----M----o-|--E---X----?-o--------Mo------oM--X--M?M-?-TX-TE--------T----M-?---T-------fE
---B------E--M?----T--X-B-o--|----M|--?X|-MM---o-o-------?-----||-B-B--?MM|B--T--?|o-T---o-M-|o?-EE--ToX-o--To--E?----TB--o-X-M---|-T----X-----E-M--X-E-------M|B-B---M---X-----?T------------X------XfM
mo-|X--?TT-------T--?-|---T-----?X-?o--------T---|M-X----TXTX-M-M-o----?-----TT-BXM------------EB?oBBoX-E----?--?-M--?E---T-XM-oB-T-o-B---EXEX?--X--M?E--o|MX-T-?B-|-------E--E--o----E|-M?-E----oMB---?
XXXXXXXXXXXXXXXXXXXXXXXXXXXXXXXXXXXXXXXXXXXXXXXXXXXXXXXXXXXXXXXXXXXXXXXXXXXXXXXXXXXXXXXXXXXXXXXXXXXXXXXXXXXXXXXXXXXXXXXXXXXXXXXXXXXXXXXXXXXXXXXXXXXXXXXXXXXXXXXXXXXXXXXXXXXXXXXXXXXXXXXXXXXXXXXXXXXXXXXX
