-----B-o----------X-?------T----o----B---------E-------E-|-|---X--------------o---o------------------------M-------------?---------E--------|------------M----|M--------X----X|--------?---EB-------o--X
-----EB--------B---------------o--X--------X------T------?-o-----------M?---T-o--T--------------B------------------|-----------T-B-X------?----E---------------------o------------M--------------------?
-|-T----------E-------------------------X------T|------------X--------MB-----------M--E--o--B-------B-M-E|-------E---M-------||--o-X|---|--------?M--B-----------|--------X--B------|--o-------B-------M
------o-------T----B---?-?X-|---------------------------o---------------------------o---M------M----------|-----------------?-----------o-----------------|------|-----T-------------|--?o-------------T
---------------B--?--?XB---------??--X-B?-------o--------------?-------------E-------M-----------------------ME-?-----------o-----E---E-T------------M---------X---X---E-----X---?|--ET-|-----B--------M
-------T--------------?-------------------??------T-T---o--------M---|-------|-------T-----E--?------------?oE---------------------------X----------------|-----|----T-------X-------------------------B
---?-------o-EB--------M------|-----------B----?B---|------|-X-------o------T-----------?----T-----M-------------?---------------E-----------T-MB|----------|-M-----------|---------E--B-------XX------E
------------------T-------------------------------X--------------E-------|--------------------------------------------------X-B--?-X--X---M---------------M----------T---?-?--------?-----------------vM
---M---MTo------E-B---E---BX--o---------o--TMo--?---X---E---E--X-X--?M--B--B---TBo-MEX---------------MT-E---TM-oToT?TT-T----------T----?-BB--To-?||o-?--T---T--E-?---?---|----X--BE-ME|-Eoo?XT--M---B-fM
--EM--M--M--TBE-B?|M--o--M---XMo-MB---o--|---o-------o-|-M-oX?-T----o-o|M|-----o?M-?-|M||---ooX---M---E-|EX---oB--X--|-X--o-----M|---X|--M-?----|---B-----Eo--o--------oTo--B-Xo-|-B-oXoo--X--|BT?---Ef?
-M-XB-----M|-EM|---?T|------B-E-o----?-B---B----E----o----?--------T-XTM-----??X|------M?---E-o?Bo---M-----E--------MX--E------T-TM-EXX-X---T---|T-MT-|o?X-T------X-----o---MoX------M------T---o----Ef?
-Eo-B-MX-|----B-----?-B|oM--o|---T---M|T----M|--T-?--o-o----B--o---T-BB--T|T-----M-----MXE|--X---B-?---|B------E-|-?--BXM-----TM-B--X--?T|X---B-B---M---B--E-M|?--M-M?-----|E-?X--E------|?---?MoBXM-Xf-
--T|-|-----X--B--|-------MTB-E|?E|B-??-X-----M|--|oX--B-X---|---E---T-BB-E-M-|-------|B--M------M-----E----o|-M----TB-E?---Mo-T|?-BB--M---T-o?-----E-|-TB-o--|--M-X-----T--XXE|-?T-EX-B-T------Eo-?---fT
--?-BoME--|---?--o-|M------X------oTo----|----T---?--|--|T---E-?-----o-----o-MX-X-o--M-----?-EM-o-B-?o--MB---|X--X--B-B|---------?o------T----E--B--E--oE--EB-?TE---?-T--B---E-E-M-T---------M---X--?-fE
mX--E---T--B-----|-----oXE|T-------TX-----M----X-----X-?---------|---T-?-M-B--T-o---X--|----|-----T-|---BM|---To--Eo----X----M--|-----BE||---X-------X--B--M----o---M---|oX|------?--oB--E--------|-BEM?
XXXXXXXXXXXXXXXXXXXXXXXXXXXXXXXXXXXXXXXXXXXXXXXXXXXXXXXXXXXXXXXXXXXXXXXXXXXXXXXXXXXXXXXXXXXXXXXXXXXXXXXXXXXXXXXXXXXXXXXXXXXXXXXXXXXXXXXXXXXXXXXXXXXXXXXXXXXXXXXXXXXXXXXXXXXXXXXXXXXXXXXXXXXXXXXXXXXXXXXX
