--------------------------------------------------------------------------------------------------------------------------------------------------------------------------------------M-----------------
--------------------------------------------------------------------------------------------------------------------------------------------------------------------------------------------------------
-------------------------------------------?--------------------------------XXXXXXX---------------------------------------------------------------------------------------------------------------------
--------------------------------------------------------------------------------------------------------------------------------------------------------------------------------------------------------
----------------------------------------------------------XX---------------------------------XXXXX------------------------------------------------------------------------------------------------BBBBB-
---------------------------------------------------------------------------------------------o-----------------T------------------------------------XX-------------X------------------------------------
---------------------X-----------------------------------------------------------------------------------------|---------------------------------------------------------------X------------------------
-----------------???XX-----------------------------------------------------------------------------------------|-----------o----------------------------??---------------------------------------------v
-o-----------------XXX----------------------------------------------------------------------------------????---|------------------------------------------------------------------------X------M-------f
------------------XXXX---o------------------------------------------------------------------X------------------|---------------------BBBBB----------------------------------------------XX-------------f
-----------------XXXXX---------------------------------------------------------------------XX-------------X----|----------------------------------------------???-----------------B-----XXX------------f
----------------XXXXXX--------------------------------------------------------------------XXX-------------XX---|----------------------------------------------------------T-------------XXXX-----------f
---------------XXXXXXX-------------------------------------------------------------------XXXX-------------XXX--|--------------?-------------------------------------------|-------------XXXXX----------f
--------------XXXXXXXX--------o-----------------------------o---------------------------XXXXX-------------XXXX-|-----------------------------------------------o--------T-|-------------XXXXXX---------f
m------------XXXXXXXXX-E---------------------E-------------------------E---------------XXXXXX-------------XXXXX|-------E--------------------X---------------------------|-|-------------XXXXXXX--------X
XXXXXXXXXXXXXXXXXXXXXXXXXXXXX-----XXXXXXXXXXXXX---------XXXXXXXXXXXXXXXXXXXXXXXXXXXXX-XXXXXXXXXXXXXXXXXXXXXXXXX|XXXXXXXXXXXXXXXXXXXXXXXXX--XX-XXXXXXXXXXXXXXX--XXXXXXXXX|X|XXX----X-----XXXXXXXXXXXX---X
