--X-----------------X---------X--------T-------------?----X-------------E----E----------------MT-T--|-oX-----T---------B-o----|------M-o--------TB----------X---M----EB-----------M-T-------------|----?
------------MT------?--?-----B---E------|---X--B--BB-------M-E------------------M-------?-M---|---M---M--------------------------M---E-----------|--|--------E---------X---------|---?---|--M---X------E
-----|------|----------------------------BT---------o---Bo-------M--?-------T-------E-|-o------B--------M-M---X-?-|-M--M------------T--------o-----T---------------T-----?----Bo-M-------------|-------E
--------------------------X----M------E-----------?----|-E----M------X---M----------------o--o---E--------?-o----------------------------------------X--------------------?------------------?-----T---T
---X-----------B------T---------X----------B---B--------?---o------------|---T|-----T----X-B|M------------------M-----|----E----T---------------------M---X--E---X--o-B-----|----?----EE---------------|
------?-------|---------?-?----------------------------X------E|----X---MB---M---o-----------B-T-----X----------B----M-Bo--------------o---M-----------MX---X--------X-------------------ET--------?---T
------B--------T---|----------X---------E----------B-?---------|----?----o---------?-----------B-----B-------?-----B---T----|------X------?--------------------------X----------o------------X-|-o-----X
-------------------------B---B----------------?-X?-o--------------------------?-------------------------------------X---o-------------------o-------------?--BT--------T-B?-o---|---------------------vX
----To-o-?-?M---o-B--oX------M-----|o--?-E---E-M-oB-M----------EB--?M|----||----------MB-o---------E-M---o--|--|-?-E----?--o-T--X---------B-------M-M?----XM----?----M-Mo-X?--E|?M-X-EEX-------B--|o-?fB
--?E?-X-BTT-?-X---TMo-XBXo-T?-------?E?--E---To-B-|--|--o-----M--X-ooE|-TT-X--?--T-?--X--T-E-|-X-?---To-MM-X---E----X-----TE----?--|--EB-|-o--|-----T-X--B---E-E-X-T?----|-o?XX--T---------?-----E---BfX
-----M----------MT-------T--M?E-T-XT-XM-T--B?X-?---B---?---?----------B?M--?T-T-E--T-M?-|-TMX-B-|---B--BTM--|----o--M----------MXX--TX----?o-oo-o-T----?o--T-MBE--E?-B-----|?|-o---|------oB--M|TE-B-?fE
-|-T--E?X--X-EE|-|o----|-|--MoE|?X-oB-MoX---oM------E-----B--EE--o----E----EB--M-B--M---Mo-E----|X-----M-M-|-o--EE------|-|?--T-----TEME------|o?X---o-?---|---o--XB--|----E---E-o-o--|--oTX-|B-X---B-fM
--X-X|----?-M--TT-T-----X------EB--oE-E?-----B||X----|-----XB?--|-------o---oBM--E-BT--E-----E-?------E-T---??--?-----TB--B-|?M---BE--o----|TTM--XB-XXoE-M------|T--T--B---X-XT---|-?-------|---E--X-?f-
---M----X-M--------E----T-?-EB---?X--X-B-?-BT----B-?---?--o-B-?---|o|oo---M-T--?XT|X-E---?------T-|B---EE---B----M|--|X|X-X------XoE--|------X-MT--------TX-|-B--E-MX--oXo-?Bo---?-BBX-?M-----------?-fE
m?------B-------M-X-|--M|Mo--E-?--B--B|TBM-?--E-?-|T---E-?----B---E------o-T--E-----E?-----------M-?X---o---X-X--E-ET--T-----?--o-E-B-T--o-o------|-E--M-o?T?-M-X?------|B---------|?--X-----B-|------T?
XXXXXXXXXXXXXXXXXXXXXXXXXXXXXXXXXXXXXXXXXXXXXXXXXXXXXXXXXXXXXXXXXXXXXXXXXXXXXXXXXXXXXXXXXXXXXXXXXXXXXXXXXXXXXXXXXXXXXXXXXXXXXXXXXXXXXXXXXXXXXXXXXXXXXXXXXXXXXXXXXXXXXXXXXXXXXXXXXXXXXXXXXXXXXXXXXXXXXXXX
