--E-----X-----------B-M---------|----X--?--------T----------------?---?---------?-------B----M---B-------------------E----o---o------?----------------------EB-------?-------T---?B--?----T-------------
------------------------------XT----------o---------E-------XE--------------M-------M--o---?-?-TT---o---|-M-------M-------------------X-|------------|------TM--------|-----------E-------o------------M
----M---------------------------B-B---M----X--X---E------------|----------o---E--------------------?----------E-----|?E------E-----------------------------------?B--T-------------o--B----------?---M-?
-----M-----------|---E?-----|--------E----------|------E-------B---------------------o---------------M---------------T-----?----------------?---------B--------?-----------Eo------M---|---o-----------o
---X---------------------------------T---|-E------------B-?-X-B------------M-----------------------------E---M--------o---ET-----------B--o------|--------X-----?-X---o-----|--T---------------------E-B
-----B-----E--?------------BM--T-----E---------M---------------------------------o------E-TT-----?---B-----------------M---B--B-----o----------B------|---------------------------------------------MT-X
------------B----------------X----------------------|---M-----------------------?----------------M-------------T----------o-----Bo-------M-BT--?oX-T------|----------------------------E-M----B------?-T
---------B---T-B---T|-?---o--------B------------------M--T--------M---M-------M-----M-----------?------E----XoX-B-----?-----?---?------|B--------TB--B--B-M-E-----------------oE--o--------M----------v|
--EE--------X-?M-?----------T--M-E|-M---T--------?---E-B-o------T----B|----|----------oEo-M?T---X-|--------------o----?-----B------o-----E-B---|E-M-B-?-|--X--T--E---------?---X-X--|-B--X-E-----?o---f|
---M|------X--|o-BX-B?-----|-o--M--T---To-o-X-oEMX-----X-B-----E--X?E-B-TE||----?|----T--T-E--T--|?-M----M-----|---o---T----oE-?--o-?-|-M----?-------X-o-|T-E--T---M-----------------T--X-BB--------T?f-
-M--o--X-|M-|---X------?--T-----B----|-|o-------o-?T-M---E---XT-X--M|----|--E--X----T--?|-|------?--XX--|-?To-M-|----MT---------T-E--T---------B--B--X------E---X----T---M--T-X-TX---E--X--?---|-X-ETMfX
-M-Eo-X--T-----E----To-M-T--?-------o---?M--XT-----M------ETo---M---?M--M-?--E---|--X-?-E?-T-X----?E-X---o-----------T------X------E-TM---T-|-X-B--ET--|----X--?-|?-------X----X--oX|-oEEB------E-----fE
-E---XEo--T-----TM-T-B--?--------E--o----M-|o----M--M-------X-|--------X-?|--X-|---T--E---XT------X--E-----Bo-------E-----|XX----B-B-E-|---|-----?----To--MB-|---B--XBE-------X--TE-E--------XB---?--Mfo
--B?-??X--?-o------------X-|-|------XXM-E-M-----Eo-----|-B----M--BE--E--------E---E|o-----B-X----X-|X-T-E----T--X--?-------o--B---------o----|E-M----oMX----X---M--E-M?X-Bo-|-T----E--EXo-X-EB--?-----fE
m---?BB---|--?-----?--X-T-M|---o-----B-?-?-----B?------M-X|----X-XBM--|--------E------|----?-XBX-?-oT-oB---o---?-MT-X---B---BE----M-----E|--E---------?E-----------X?---B--|M---M---?||--|E--E---E-BMMX-
XXXXXXXXXXXXXXXXXXXXXXXXXXXXXXXXXXXXXXXXXXXXXXXXXXXXXXXXXXXXXXXXXXXXXXXXXXXXXXXXXXXXXXXXXXXXXXXXXXXXXXXXXXXXXXXXXXXXXXXXXXXXXXXXXXXXXXXXXXXXXXXXXXXXXXXXXXXXXXXXXXXXXXXXXXXXXXXXXXXXXXXXXXXXXXXXXXXXXXXX
