-X-----T-B----------------?-?--?-------X-------E---------M-----------------M----M---------XE---------X----------oM------X-------------------------M-------------------B--M-|-------------------?-------M
--------------?-------------------------------|--------------XE---X------------Eo-------?----------E-o-----X-|---T-------M------E---M--------?-------------------------E--o---E-------X-----------B----X
--o-----------------T---E--E-?--?B-------------------------X---T----------------M----------?-----?----XM--------------?------|--X----------o------------M-------------M-----------o---E----------------|
---------------------------o------------T----------Xo----------X---B-|----------T--B---M------T-E-----------------------------------?---------------o|-----o-M----XB-------o------------?-----------M--B
-------------|----------------?---------------------E---------------T---o-----T-------o-BX--|-----M--------------------T---E-----oX------------------E-----------B-----------|-----?-------------E---?-B
--------?--------T-------E---MT----------------?-------------|------------------------M-------------------|---B-o-----E--X------Xo-----------X----?---|-------------X-|--B--------X----X-E-----X-----X-|
--|-----T----------------B--X--|-----------E-o--X--XE---M--T----------oB-XTX-M-T---oX---------------?-----------------|--E-o-----|---E------------------|-----|---B---M----T--B-|----BX----------------?
---------------E----?--------|----o------------------BE-X------|----------------M|-----B--------------------M----E-------------M--------B-?----o-?-----------o--E--E--------------------------------o-vB
---X--M---T---To?B|-X-o---MoE----M--o-----|--B--X-|--?|---|BEo-|-----B--|---E--?-?MT-------?--TT--------|--o--X------B-X-|-?---T--|---------T---M------MB---?-----Bo------E-TX--?T--MM-o--ET----T--ME-fE
--oX---M?--X|o--X-----------B-X------?-T-oo---E-E-----XE-?-X----EX----M----o|--------BT-X---To---------M--E---|-B------|X-o-------M-----Xo-----------X-o?-EM-?|?-o------------EEM-XT||-X-------B|--oX-fB
--X|-o---XM---T--------B-X-XM---B|--XXME--EB-B--Xo-BX-------------EE--E-B------T-----T--M----------|--|--?|-------B--E-M------M|-M|-B-TB-----X---T-M-B------------?X|?-?-?BT?EBE--o-----E-------T-TM?-fT
-B--o--|------X?--XX?o-?--------|-M----|---MX----XET---B---BMoM|-----T-B---X--T--o--------B-------------|B-------EM--------------|TT?----||--------M-E--o?---TTEM------EXE?--TM-|-EE---------T--|---M-f-
-M------E--B---EE-E-T------EoX----?-|BT--E---T----B--|M?XX--o-----XB------X-oXo-----M--|-|XE----|T-|--EB?XT--oT-----?----X-T--X----?M------o-E---M----E--B---X|?-X-B--------o----|----|------Bo--|---Xfo
------E--M-o--X--|-M---Eo|---BT--|--------X-----|?-EEBXoT-------------E-X------T-------ETo?|--T?----?T------EM---E----T-------o-E-|oM-?-oE--|o---?-E?---?M---|--|E--B--T--|--X-|----X--M-----o--------fM
m-||-M---X---------E--BB?-X---B---|E--|--T?----?M-----o-X-X-||-M|-------M----B----B?XX----T--------B-?o?----X--M--MM?E--T--TX----------BE-o---o---X---M-T-----|-|MX-?-T-|oETB-o|--?X-E---E-----?---M--T-
XXXXXXXXXXXXXXXXXXXXXXXXXXXXXXXXXXXXXXXXXXXXXXXXXXXXXXXXXXXXXXXXXXXXXXXXXXXXXXXXXXXXXXXXXXXXXXXXXXXXXXXXXXXXXXXXXXXXXXXXXXXXXXXXXXXXXXXXXXXXXXXXXXXXXXXXXXXXXXXXXXXXXXXXXXXXXXXXXXXXXXXXXXXXXXXXXXXXXXXX
