----?---EB-----------------------M-------------E------------------------E-----Xo--o------M-------B-------?---------X-------------B-----?--B-------------------M--------------------------------E---X----
-------------?--?---------------X------------MM------?------?-?--B--------------B---?----------------B---------------B----------------B-?X---------EX--M----------B-----E-----o-------------------------
----?--------------------o------B-o-------------XE---------------MEM-----------?-------X--------------B----M--X---------B?------??-------------o-M------o-----MM-----------------------------E----o-----
---B--?--------?---------------?-----------------M-XB--------B------------------------------M----------------------o-?----M--E------------o---------------------o----------------------M----o---B-------
-----o-------------------------BB--?-M--------?---------------M-----------------E--E--------X----------X------------------o----o------X------------------?---B---------------------E-------?-----o-?----
-----B-----------E-Mo--------M-o-----------?X--X-----------------------X--------------------E------------------M----Xo---X?-?----------M---?-----------E--X---?---------oXEB--o-----?---X---------------
---E----------------------------------B-E-----------?M--------M------?------M----E------X-----B--------o---o-X-M-----B------------B-M------------------------------------------Bo-M----------------X----
-------------------------?---------------?--------------o------------o-o----------B--B------------B-----------M----------X-------------------E---------E-------------------------M-X-Bo---------------v-
---X-----E---B----o----B--?----o----?----------M----?--X------E--X----?BBE-M---X---B--------X----------M---B-o---MM--o-E-?---X-XM------EEE----o---o--M---X----------------BoE--------oE-Eo--oX---M--?-f-
---X----------X----X---M-oo----B-E--M---B-X-M-E---X-----B-B-----BB--B-B-?----B---M-EM-------o----?--M---------X--Eo---M---B-EE-B---X-E---XME?o---E?-----?-XE--MX----------------?M----E--o-?E---------f-
------M---?------E----X--B-oo----Bo-?-o-----?E-------B--?-MB----X-?--o----?--X--B-----?E----B-E----o-----?B----?----M----X--------o-----X?MEM-----M----oB----X----M--E---B----------X-o----X-B--B-MM--f-
-B---?---?-B---M-------?EXo----B--------M-o-E-o-E---oX-E---Eo----B---oEB---M------E--M-----------o-?o-MBX-M--M---?-----o------------X----MMEoX-----?-B----M-----------X-----?B-E----------------------f-
------------------?---?---?---------o?-----B----?----o?M--?----E-E-------??-----E-?M----?-X---E-----------o----XX--B----B-------?---M---X-----?--B----E--oE-?-X--B-BEo---?---?M-----o--o-o--EB--------f-
---?---?--?-TM--T---B-E-T?--EM-T-M-?-o--X?-------BTEX--?Bo-BE--XMXB--T---E---T-------E-----------oEMEo?-EBToB-T-TT-T?-E-ME-TBTE--BTTB-------EE-------M--E---B-T----T-o-----X------X-TBX---ET-M--o-To-of-
m?M----M-?--|--T|E--BMT-|E---|-|-E--------BXM---MM|-X----|-B-Xo|--E--|T----|-|---------TX--E--|E-BE---?X?-|---|o||||EM--o--|||Eo-|||---E---E-To-o--T-M-?----|-|T?--|?-?oo-T----M|BT-|?TE-XE|?B-M--|---f-
XXXXXXXXXXXXXXXXXXXXXXXXXXXXXXXXXXXXXXXXXXXXXXXXXXXXXXXXXXXXXXXXXXXXXXXXXXXXXXXXXXXXXXXXXXXXXXXXXXXXXXXXXXXXXXXXXXXXXXXXXXXXXXXXXXXXXXXXXXXXXXXXXXXXXXXXXXXXXXXXXXXXXXXXXXXXXXXXXXXXXXXXXXXXXXXXXXXXXTXX
