-----------------------------------------------------------------------------------------------------------------------------------------------------------------B--------------------------------M-----
-------?------------------------------------------------------------------------------------------------------------------------------------------------------------------------------------------------
--B---------------------------------------------------------------------------------------------------------------------------------------------------o-------------------------------------------------
---------------------------------------------------------------------------------------------------------------------------------------------BBBBBB-----------------------------------------------------
-------------------------------------------------------------------------------------X---------------X--------------------------------------------------------------------------------X-----------------
------------o-----------------------------------------------------------------------XX----------------------------------X---------------------------o---------------------------------------------------
---------------------------------------------------T-------------------------------XXX---------------------------------------o-------T------------------------------------------------------------o-----
---------------------------------------------------|------------------------------XXXX-----------------------------------------------|--------------------------------------------------X--------------v
---------------------------------------------------|--------------X--------------XXXXX-----------------------------------------------|--------------T----------------------------------XX-----o---M----f
---------------------------------------------------|-------------XX-------------XXXXXX-------------------------------o------------B--|--------------|-----------------------T---------XXX--------------f
---------------------------------------------------|------------XXX------------XXXXXXX-----------------------------------------------|--------------|-----------------o-----|--------XXXX--------------f
---------------------------------------------------|-----------XXXX-----------XXXXXXXX-----------------------------------------------|--------------|-----------------------|-------TXXXX--------------f
---------------------------------------------------|----------XXXXX----------XXXXXXXXX----????---------------------------------------|------------?-|---o-------------------|------X|XXXX------------X-f
---------------------------------------------------|---------XXXXXX---------XXXXXXXXXX-----------------------------------------------|--------------|-----------------------|-----XX|XXXX-----------XX-f
m--------------------------------------------------|--------XXXXXXX--------XXXXXXXXXXX----------------------------o--------o----E----|--------------|-----------o-----------|----XXX|XXXX----------XXXEX
XXXXXXXXXXXXXXXXXXXXXXXXXXXXXXXXXXXXXXXXXXXXXXXXXXX|XXXXXXXXXXXXXXXXXXXXXXXXXXXXXXXXXXXXXXXXXoXXXXXXXXXX--------XXXXXXXXX--------XX-X|XXXBXXXXXXXX--|---XXXXXXXXXXX--XXXXXXX|XXXXXXX|XXXXXXXXXXXXXXXXXXX
