----B-------------------?--------T--EM---?------M--B--X-----B----o-----E------B--X----B-------------o---T----------ET---M-|-X-------E---?---------------|--o--?---o-?---------M----o--|------------E---M
-----------?---------------X------B-?----------TX------?X---T----------------M----X--M----T--o---E-B---X-------|T--M--------------|------|--M----E-?-----------T-X---T-------B-----B-------------------|
---o--M|--------B-|?---------TT---M-----X---------------T-----?---------------T?B------------E-o---T-------------B-B---E-------------o------?----------X-T---------B-------------X-------B----------T--M
---------oo------E------B----|E--------------------------EE--M---------?-------T--|--------X---------------------------?|------X---------B--------?----------------o--------B?----------BE----X--------X
--------o----E---B------------------|---------|----o-|-----oo-----------|--------------------M---|--ET---------------X---------------B---X----------T---o-------------B-------T-------?-----X----------X
---B---|-?----------E?--o-------X-----------?---TM----------------T----o--|--------------------M----------------o-----------E----T--XB-----E------?M----------------|-B--BM-----------E?--o----T-------E
----------------------oX----------------|----X---|BX----?X---B------o-----------M------------?---?--T------E?--Eo-----------------|?-||-------B------E---------------------o-------E--B-------B-M--?---E
-------B-----EX------|----?---|-------M--M---|-------------MTX----B-X------M---------------X-------------?-------o---------B-----|----X--M---------|X---T---?---------X------X--?-M---------------o---vB
--T-BM--BB-T|M------E-----XE-|------M----?|B|-?------B|---E-TM------E--MX-X-E-----o-----------X--B---o-|E-E-ME-----X-X---EB---XEE-|XX--o--?-M----oTo---?o---ET|E|-MB|oX----M-T-B|-----TMEM-|-----|----f|
-------------|-BB--M--|M-|---o----o-o-----B-MM----MX?T-E--|--o--E-|--MoBBX-MoTXE|--MM---MX|-----B---o--M--------------?-B-?XT-?--?---Mo---|--oE-|-M----X--??E--|--M-TBBE-M--T---XT-|-T---|-XT---------f?
-MM------M------|?-||--To--T|-|X--?M-----|?-B--E--|E--B---EXE---B--MB------XT--TB---E---M--TT---TX---EM-XTMo--T-o-T-T-E-----T----E------E--BT-EX-oB----EX--o-?T-M----BM----?---------|-MM-E-B--B-|--|Ef?
-------B?----|--M-----|-T----------B----E?oo---X-------|--MX--------------?--M---------|E---M--------X---XE-------|B-----E|B-----|?-E-E?--o-----B-----M-T--X--o-----------?-BoXM----X--?-ooB?---T--E--f-
----------?E--M----MX--T--o--o--T|M----oX--XX--TM--?----T-E------X--X-X-T-TT-?-B--E-B?--BE-o-o-||B?---M-|----B-EX|-|-XM------------B--|EEo--E?B|------|--?T-XE--M--M---o-----B-X---B---?X-X?--oEX---XMf?
--?----|M-BM-BET--EB-o-|---MB--T-B--B----T--|----M-X---o----B----M---oT---?ET----EB--?E--|ooM-M----?-M--E-X-X----?|-----------?-?---|B-X--M---E--oB---BM-oE|X--|-E---------X-----o------EE-?T---T-X---fT
mT-----?---B--|-M--|--T-M-----Mo-TB?E--E|X----MoB---ME---ET------||--E-T|-T-B-|---B-TEX--|----------?-X-TB---?-M-------?-?T|B|------?--o---?XX---T-T-------B-T--|-E--E-T--M-M----MXM--?o--|M--??-?M-X--o
XXXXXXXXXXXXXXXXXXXXXXXXXXXXXXXXXXXXXXXXXXXXXXXXXXXXXXXXXXXXXXXXXXXXXXXXXXXXXXXXXXXXXXXXXXXXXXXXXXXXXXXXXXXXXXXXXXXXXXXXXXXXXXXXXXXXXXXXXXXXXXXXXXXXXXXXXXXXXXXXXXXXXXXXXXXXXXXXXXXXXXXXXXXXXXXXXXXXXXXX
