-B---------M------------T---------|------------------------------------------------X------------o-----------------?---------E---B?--------------T----o-------------------------X------------X-T--M-----T
--|T--------|----------|--X|----XE--o-------B-----T------------------EB------B|----oT-X--T-------M---|-o-----------------M-----X|-oX------E------B-----|-------?-|----------B---|---?------------------o
------?-----M-------|------E-------T--EB--Eo-------------------X----------o---X----B-E---E-B---?B--B---o-?---------------E------|B--------o--X--|T-------?B----?--------------T--------------T---------o
--o---B---------|----------------X?--E------------T--------B--------B--------T----ooo----------------E----------------B---------|----M----------------M-M--------------------------------------XT-------
-?---------M----o------------To-------E-----?-?--------ET-----------------T----T---------M-------------o--------o----X-------------|---o---|---B----BX-----------o?--MB---------|X------------------?--T
---------------------------------M-----------E-E---T-------X-----E------T-o---------o------------------------------M--------------------B---?----------o-------------------|?--EB----|-E---?-----------M
------?B----------?---?------------------?----------o----|---M-------------M-------------------------E--X-------------o-X-M-?--X---||--?---?--o----BEB------|-o------------oT---------o-TM--E-?------X-?
-o--------T-------?---------T--T--o---|----?-----X----X--?----M------o--|---T-?------T?-----E---------------------M---------------------------------------------B-----X----o-------------------B|-MX--v?
--T----------E---T--o-?-To---XX-M----------?----|T---TE---|-E---|-X--TM-----E--|T----------M---B---E-TM---Xo-T-----TE-T-------TT-----o-----E--oMEX--B--T-X-M-XM-|-B-TE-M--M?--EoX----oM--?T-M---EXT--XfM
-EBE----|-|o----MB--EE--?o----BE---B--------|-T---M----T--?-T-B---T-|?E-|X-M-BB-M-M--E------M--?o--o----o--To--|B?--o---E---o-BT|M-X--|-M-|XX-o-------|------M-|oo---XB-TM---Eo----B--BBoM-----B?---M-f?
-X---XX----E-o----XM?TTT|---------TM-?------------EB--B-M--XB-BBE---|---T------T----T---o------T-M----?E-------E--M--|B----o--?X---X----------------TXT--|---BTE---B---o--X?---XT-E|---E-T??---?---o--fM
--------|------T-----|-XTB-X-oB---EB-ME--?|EX-o|--E|B----T------B--?----?----|T?M|-M----XT-T-TX------oB---X----oBT--E|---T---EEE--X-?B||------------M--TTM-----X-M-B----|-----?|T-?-X---E-|B---|-o--|-fo
--?--E-M----MEXXBX-------BX-|-E-T----MB--??E--??-X-X----|----T|T-M|-BE-----?-?|-TET-B|-|E-M-B---?--||o--?-T--E---EX---|--EE--|M-----o----E--X---MBB|?--M--M|--?--oBT---?X-X--o---E|---o---o-E--o----X?fM
-----X-|----o--?---XoT|B-T-TXE---E----|-----M|B--|-TXEM-?TT-BM----o---ET----B-E--------B-|-|---o---|-M?------|-----?------|----|T---B----?oT-B-B----E---?-----XT---T----T---XE-T----|---B----|XX---M--fM
m------|---MT---o----EB-?M-?-X|X---M|T-|-B-|B-oM---B-MX-T---X-|-|T---------M-ToX-|-----oBM----|?------??M-----------B---MT-X--oB?----o----EX---Bo----MX?-T?B-B-o?-T-----------T|-TTTE--T-TTo--T-----T--?
XXXXXXXXXXXXXXXXXXXXXXXXXXXXXXXXXXXXXXXXXXXXXXXXXXXXXXXXXXXXXXXXXXXXXXXXXXXXXXXXXXXXXXXXXXXXXXXXXXXXXXXXXXXXXXXXXXXXXXXXXXXXXXXXXXXXXXXXXXXXXXXXXXXXXXXXXXXXXXXXXXXXXXXXXXXXXXXXXXXXXXXXXXXXXXXXXXXXXXXX
