-------------?--E----M---------B-B-E------------------M-----------------------X---------M-o--------M---------------------B-B------B----------?-----X------E-o-E-----o-----------------------------------
----?------------------X-------------M----M---E--M--------E---------E---B------E-----?----------E--------------------------B-------o---M-------M---Eo--------------B--M----------?------------------E---
---------------------------------------------------M---------------------------?-------X--------------B----M--X----MB-----?--------?----?----------------------------E----------MB-----o----------------
---------------?--M---E-M-------------------o-----B----------------------------?--------?Mo---------------------o------M-----E------------o-----o--------?----X------------------M----------M------M----
-----------------B--o----------------M--------?----------E---o?--B---------o-B------E-------------E---B-EX---o--?-----------o---------?-------------------------------?----M----------------------------
-------X---?--M-------M-------------X-------------E---------MM--------------E--?--E---------M--------E-----------------------o-E--?-------?---------o-------------------?------B-------o----------------
-----------B------------?X------------------X------------------M-X--o--B-B?-------------X--------X--M-------------E-------oE------o--------------E-----------?---------------E-M---X--------X--M--------
-----E-----------M----M--------?--------------o----------M------?B-X-------B--------------B---B--?-EBo-------------------------E------o--------M--o-------X-----o-------M------X----------B------?----v-
----o-------------EB-----?o----?E-B-Eo----B--B-----B--E-----?--M---B-XE--M-?--M-----------M--X---------M---B-o---MM--o-E-?---X-XM------EE-----o---o--M---X------------X-B----?-----B--M--E--X---E--M--f-
----?-B-B--B--E-----M-o--MoB-M--M---M-B--?---X-EBM--M----?--oo--------XE------oEE--M----M------M----X--o------B-------?M--E----M-X-----------B--?-E----?-----B------o--------------?-E------XX--XM----f-
----?M----------oX---E?-Mo-E------?---X---B?---o-?-o---------XM----?---?-o--------?MM----MX-----M??---?--X--ME-B-?-EE--X-----Eo--------X-------M-------?------------------??-o-B---?-M-?--------------f-
--B----B------------M------?------B?--M-M-BM--o-B?----------E-o-B--??-------X--o----M-----B-M------X--M-oB-?-----E------XB---?-M--B--E--E-?------oBE---oE--ooX-B-??B--o--X--B----------?--?M----?--M--f-
--o---M--M-E--M---M-X??BX-BX-----?---oX------BB-BE-B---o--------MM---B---B----E-M------X-----?M-E-------?-------X---E--oM-?-----?----M--X---------Eo-MXEMB----X---BBM------?MB---Eoo--M-E-M---------E-f-
-B--oo---------B-----T-X-o----XBB-X--T----M---XT--T--?-B----------T-----M--?-M----?-T--E-ETM----T-Too---T-T------T---X---M-X---E--T----?-B-M-ToTX---Bo-----M--X------TToX-MTMME-E---T--T-XXX---E--?---f-
m--Xo---------?--Mo?-|---------T-X---|-ME-X----|M-|M-X-T--?X------|-?--B---T|-o--?-o|-T-XE|--XX-|-|?--X-|-|-BM---|?o------------|T|-M-M--?E-M|-|-?--XM-EM??--E---ET--||-B--|MX?M----|--||-E-----BE-|--f-
XXXXXXXXXXXXXXXXXXXXXXXXXXXXXXXXXXXXXXXXXXXXXXXXXXXXXXXXXXXXXXXXXXXXXXXXXXXXXXXXXXXXXXXXXXXXXXXXXXXXXXXXXXXXXXXXXXXXXXXXXXXXXXXXXXXXXXXXXXXXXXXXXXXXXXXXXXXXXXXXXXXXXXXXXXXXXXXXXXXXXXXXXXXXXXXXXXXXXXXX
