---------------------------------------------------X-------------------------------------------------------------------------------------------------------------B--------------------------------------
--------------------------------------------------------------------------------------------------------------------------------------------------------------------------------------------------------
------------------------------???--------------------------------------------------------------------------------------------------------------------------------------------------------------------B--
------------------------------------------------BBBBBBBB---------------------------------------------------X--------------------------------------------------------------------------------------------
---------------------------------------------------------------------X-----------------------------------------X----------------------------------------------------------------------------------------
----------------------------------------------------------------------------------------XXXXXXXX--------------XX----X-----------------------------------------------------------------------------------
-----------------T-------------------------------------------------------------------------------------------XXX----XX----------T----------------------------?------X-----------------------------------
-----------------|--------T---X-------------------------------------------------------X----------------T--T-XXXX----XXX---------|-----------------------------------XX--------------X------------------v
-----------------|--------|-----------------------------------------------------------XX-o-------------|--|XXXXX--o-XXXX--------|-----------------------------------XXX--------------------------------f
-----------------|--------|-----------------------------------------------------------XXX--------------|--|XXXXX----XXXXX-------|-----------------------------------XXXX--B----------------------T---?-f
-----------------|--------|----------------------X------------------------------------XXXX-------------|-X|XXXXX----XXXXXX------|-------T---------------------------XXXXX------------------------|-----f
-----------------|--------|----------------------XX---------------B-----------BBBB----XXXXX------------|XX|XXXXX----XXXXXXX-----|X------|-----------------------M---XXXXXX-----------------------|-----f
-----------------|--------|----------------------XXX----------------------------------XXXXXX-----------|XX|XXXXX----XXXXXXXX----|-------|---------------------------XXXXXXX----X-----------------|-----f
----------T------|--------|------------X---------XXXX---------------------------------XXXXXXX---------X|XX|XXXXX----XXXXXXXXX---|-------|---------------------------XXXXXXXX---XX----------------|-----f
m----E----|--E---|E-------|------------XX----X---XXXXX--------------------------------XXXXXXXX-------XX|XX|XXXXX----XXXXXXXXXX--|----X--|-------E?------------------XXXXXXXXX--XXX---------------|-----X
XXXXXXXXXX|XXXXXX|-----XXX|XXXXXXXXXXXXXXXXXXXXXXXXXXXXXXXXXXXXXXXXX--------MXXXXXXXXXXXXXXXXXXoXXXXXXX|XX|XXXXXXXXXXXXXXXXXXXXX|XXXXXXX|XXXXXXXXXXXXXXXXXX-----oXXXXXXXXXXXXXXXXXX---X-XXXXXXXXX|XXXXXX
