--------------------X------M-------------------EE--X-----------X--BM------------?-----B----B---------o---------E---|M----X-E---------T---T-----B-o----------------?|---o--X----B-----------------------|
---------------T---------------------------o---------------------oE---?--o----------o-----|----M---------|----?-----B----------------M-M----o----M-o----?---------BT---|----T-M--o------E--------------T
----X--------o-B------o-|------BM-B-----------------------?------X------M---B|------------M--------E--o-o----------T-----------------------------------?-|----M--|------X--?---M-X---?--|--------X------
------------|--------------------------------o-----------------------------------T---------------------T-----------|---------E--------MB---B-----------------------------E-----------------------------|
--------E--M-------------X----To---X----E--|-----X----?--?---o----?--oX-|------------------------B---------------B-----X-T---E--------??------X-----?-T------------------T------o-----M?---------------M
---E----------------X---E-----------E-----------M--T--------|-----o----------------o-------T----X-B-----------------X------------------------o---oT------------M---M-M-----B-------o------?--------o---M
-------TT--------X--X----------M------|----o----T-------TM--------------B--M----------E-------oE--------------------------X---------EX-------------------|E---------E---------T--?-----------B----T----o
--T--X-----------o-E--------o---X---M------X---B-M--M------X-----?-o-TM------------EM|o---------------------?--T|---E-----BX----??-----|-----o-B------------E-----T------o------------B---o-|--|------vB
----------X-----XTXXT-----o------BM-?----X-?X-?-M-|--??XX---T--ooooE-E----?M-M--T--Xo--o||-M-o------T-XX-X---T---X---B-B--?--T--T-T?T--|--o-----X---M-B----M---M-T----BE|-?-------?--------T--Mo---B-Bf-
---|--?-M--------E---E?-B-oBETM--?-M-E--------Eo--XT---oB-E-o------X-M------XBT-B--------T?-M-|---?-----T---T--M----?--o---ME---|----?----E----oM----?-----M-o-T-?---E---?-------?------BT--------|-E-fM
--o--M--ToB--ET-o--XX?-o---E--X-------|?---B--T--X---E-------o?---E-E-Bo?--E-EE-MMo-X--E---M--?--|-----oTT--Eo?--E-E-----E--M---o--T--?EBX|--o-----X----M--?-?|-----X---T-|--o--M--B--T|B?|X-X-E----B-f?
--?B---E------TB----M---|-T--Xo|-?-B----o-|-oB---------o-|-T--T--|-----|-?-----??-------B?-?-B---o--MB-E--?E-?E---BE-BB-?--MB?--E-X--E-?-oM-TE--MB----o|---o----------B-B-B-B-E--E----T------o---E-ooEf?
---Bo-------T---|TEX-X--B--M-oE----?-M-----o-----?-B|-----|-T--|-MB----|-----BBo--MX-----X--?ME--||E-----------|--?--------XE-----?E-||T-XT-----T---M-o----T-E?-T----o---|-ET--?---o-----|---T-B--?---fM
--|---M----------?------XX---------T----E----E---o----M-?----EEM--X--M-----E-?-T-X-Moo--BEX|-BXE--M--X-?MT--B|-----|---|-M?--o-?TB?-------B-----Mo----o---|E-|-M-X---|--|-M----BE-----o|B----|o--?-|-Mf-
mME---MBo--------EXBo---|-TT-|-|---o-o--M---B-----------o------B-X--T----M-T?|--X|-M-----o--M-?-|--T--|B-T--T-EMo-T-T--B------|-o------T-------B-?T-----------E--ETX-----|-----o--|--E---|?o?-?--E---o|X
XXXXXXXXXXXXXXXXXXXXXXXXXXXXXXXXXXXXXXXXXXXXXXXXXXXXXXXXXXXXXXXXXXXXXXXXXXXXXXXXXXXXXXXXXXXXXXXXXXXXXXXXXXXXXXXXXXXXXXXXXXXXXXXXXXXXXXXXXXXXXXXXXXXXXXXXXXXXXXXXXXXXXXXXXXXXXXXXXXXXXXXXXXXXXXXXXXXXXXXX
