---|o-X-----------------------------T--E-------------|--------------------X---------o-------------o--?----X---------------B-?-?X-------------M------B-M--X-----M-TX?------------E---?--EB-----B-E---M?-E
--T---------B------------B----o------------------------E-B-----M-----------------M-E---M----T----------------------B--T-----?------------------|------o------|B-------|--------------|-----------B-----|
--------?----|------------T----------T--?------------B---?--T---------|-------------E-------------T--M-----X--E-|?-T--?------?-X-X-X--------------o--M----M--M----T----------------------o---------T---?
-----M-------------o------M--------------M-----------------X|-M---------o--E----------oE?---------o-----------B--?-----T----E-------------------?-------------X--M--------o-X----------E----------X----E
-----------------|----E---E|-|------B--MT----------|-----T--?--T-M--?----------o------------------T-------------o--------|------------TB-----------T---T----E-------------------T----------------------B
-B--------------------------------E-M----------M-----M---E------B---------B--?------------B---o--------?----B-----X--------|----?------B-----------E--XM----T--------------E----?------------X-----|---o
-------BToE|---|---T--o-----B-|----|--------X-?-------E----Bo----E-------------B-------X------------E---|---MX----------------------X-------T--------o-T------M---|E--------|---?-----------------X--o-?
---------------------X---------B----?-----Xo-----T-----------------------o-------------------M---------B-------oE--X---------------oB---?B--T----------X--M----B--------------X------|------|---------vT
-B-BBo-M|-TE-o----B|--|----TXEE-XTE--o|TB--------M-X---B-?T---XB|E--E----M-EX-X--T-X-TT--TXX--M-E?-TX-----T-M--T-T|-------M--E|T---oo---o-X-----B--------o-XX----?T-E-|-||-?--------E-B-XE--M--MMoMoE-fo
------X-E-MX-T-XE--TM---B-?o----XE---X-B-----M----TT--X-E|MX-E-B-----B--||-B-----X-?-----|---X-------BTM---MMM-----------M-----oo--------M--E---T|-BB-----T--------?T|-?-o|?BX----T--B------|-XB------fM
--?----------|o-----E-M-To|B-E------MM-----X|T?o--B------oBX------B----X-B|oTE--T-T?ET-|--------------B--T|-M-B-T---B--T?|TXB-E------?--E|-MTT?-T--?----X-|-------XX--?B--------|----M-|---EX|XE----?Ef?
-TM--?---TT--M|---EX-|--?|?X?X---E--T|--oM-|---T-TX---o?-|----B---T----M-?T-M?-M------M----|---|--|--Eo------E---|-----|--M---B-|------TT-?--------T?-----M--MB-Bo-X-?EM---M|---BB--?---B-?--B----XM-Tf?
-BEEE---o-------|--TT---Boo?-------o-------o--oM---X----M-T|------E-M--o|--M---|TE----T|o----T---o---o--X--o-T-M-??--o--BMM-B-T----B-B----?-o|-o---o|-?TE||oT|E------M--o--?M----M-?T---E--T-EE?T---X-fo
--T-----EM-M--BB---M----E?X-------MM---BT-B---E?T---|-E-?----XMX?-BB----|-------BoX--TM-------------------|----?-M----E-T--E-T---M---X----E-M----B--X-----|--|-----------X?-----M----o--?----BE--E-X--fE
m----o-B---M------E---M-X-----?--X--M-Bo-X---X-?-M----E-?T-X-X--------oX-T--E-|---B---?-----o-?--T--?-|E-M--X-E---------?-M-|-B-TT---o-----------|B-|EE-o--|--------T|T---X|-|T---X--B--T---X---oT--oB?-
XXXXXXXXXXXXXXXXXXXXXXXXXXXXXXXXXXXXXXXXXXXXXXXXXXXXXXXXXXXXXXXXXXXXXXXXXXXXXXXXXXXXXXXXXXXXXXXXXXXXXXXXXXXXXXXXXXXXXXXXXXXXXXXXXXXXXXXXXXXXXXXXXXXXXXXXXXXXXXXXXXXXXXXXXXXXXXXXXXXXXXXXXXXXXXXXXXXXXXXX
