------T---|--?-----X--?------o-----E---X---M----X----B----E--------M--??-o----------?------?M----B-|-------------T|--------------E----T|---B|------?-TB--------------?o---?------M--B--T-|E-----oX-----M
----------------To-----E-------X---o-------B-T------B------X-------E----|o------|----B|B---------------?---B|----X--------XE--------------------M------o------|---?--|-T------?--------X--------X-------
-|--------------o--------|------M-T------?---E-------?----------X--|------B----T--M-----|-|------?T---X-------E?-|---------------X----B----X---------|T--|-T---E--T|-------E-------------------------X-T
--------------o-X--B---X----------?-|----M-E---------|--?--M-?-----------?----------?-------?B----------E----o-|-----X---T--B--------------------B-T-o---------E--?------B-----------------------------X
------------B-------------------------X---?---E----|--------------------M----|--X---|o-----------?T|-o---M----E--------B|?---M-------------------EE---------------T-?----------X---M------XB------o----|
----------T------------------?-----------------B-------------------B----B---X-E---E--------X------------------|-T---------------------------o-----------------------B-----T---------T--?-----------X---?
--|-----X------XoT--?-----|--------------------X--?-E-------X-E-----------------------X------------------E--------E---------------T-B---EB---E-------------------E------M----M-----------M-------------E
----------T-BT------|------M-X--|--M-o-X------E-----o-X--M---------------X-------o--?-E----o|----------X-------o----M---M---E------M------E-E---B|------------------B--|-------?------o--------M------v|
--o|----?E----?--B-?T------M--M---o|-----|-?XT-B-X---------BX?-------X----|--------------XX-?--|T?E---------EoXMEE?o---TEo-M||T-MB-T-o-E--BE-?---MM---o-M--o--M-o--|-------XB-----TE?--EX?----T-X--MX-f?
---o--E----M------E---?---|--B---o-----------|------BoB--T||TT-|----E--------X-X-TX--T--oB---B----E-T-----?----BX---E--?--oXTM---o-|??-M--B---T|X---E|---TEXT-E-XE---X-----E---?--|B---B-----XX--M----fo
-----EM--o------o----o-X--?--|--|B--X-----|B-|B----|-----?--MT--o|--|---XE-|BTE|M-M---o-M?--|T|--TE---T------------|----X|--|TT--o--??X--------?--T----EE--E|-M----X--E?-T-X-BT--BT?M?TME---------T-E-f|
---?-----BE-E-E------|BB-----B---E--|------??-E---------BT-B-----------XXX-X-----T-o--?--o--X--E----BX-M-----?----T--o---M|-X|---?|---M-E-M--?T-B-|---?-Mo----TB--oo-TT-|T-T-------B-?-|B|T-T----X----f-
--B-X------B-------o---?-|-M-X-------o?T--EE--------E--?---M?o|--M|----B------o--|MoM-----M-E-E--B-B--|T-E--o----|-XB?-?-|---?-MTMB-----B-M---|X----|--E--E--T-T-M|E-----M----o--T-----E--XT-|E--MM---fX
-X----?--Bo--?-----?-X-o------XEoXM--B--M---M|--To-E----E?-T-BX|----B-----TE------BB-EoB-----M--X---oX---T-MB----------|E---M---M-TB--?--M|-o--B-----||---o----XM-E---BT------BM?M-MXT-|-?-o---|----?-fM
m|TE-----Mo--?-E-o------ET-------??-M-|--|----|M?--EE----o----TX---o----?TEB-----X--X--X----T-B?---?--Eo---E-B--?BXT---B--o|----E--?-MB----E--T--T---MTB-T-EE---B-BEooo--BX?-M--B---B-----------M--M-o||
XXXXXXXXXXXXXXXXXXXXXXXXXXXXXXXXXXXXXXXXXXXXXXXXXXXXXXXXXXXXXXXXXXXXXXXXXXXXXXXXXXXXXXXXXXXXXXXXXXXXXXXXXXXXXXXXXXXXXXXXXXXXXXXXXXXXXXXXXXXXXXXXXXXXXXXXXXXXXXXXXXXXXXXXXXXXXXXXXXXXXXXXXXXXXXXXXXXXXXXX
