------------------------------------????-------------------------------------??????----------------------------------------X?--------------------------------------o------------------------------o-----
------------------------------------------------X-----------------B--------XXXX---------------------------------------------?---------BBBBBB-------------------------M----------------------------------
--------------------------------------o--------------------------------------------------------------------------------------------------???------------------------------------------------------------
-----------------------M-------------------------------------------------------o---------------------------------------------??-----------------------------------BB-----T------------------------------
----X--------------o-------------------------------------------------o------------------------------------------------------o------------T----T--------------------------|------------------------------
-----------------------------------X-----------------------------------------------------X---X----------------------------------------o--|----|--------------------------|------------------------------
-----------------------------------------????????-----------------------------T-----o--X-XX----------------------?-----------------------|----|--------------------o-----|------------------------?????-
---------------------------------B---------o----------------------------------|--------XXXXX--------------BBB----------o-------X---------|----|------X---?????--------BB-|-----------------------------v
------------------------------------------------------------------------------|--------XXXXXX---------------------X-----------XX------T-o|----|------XX------------------|-----------------------------f
----------------------------------------------X-------------------------------|--------XXXXXXX-------------------XX----------XXX------|--|----|------XXX-----------------|-----------------------------f
------------------------------------------------------------------------------|--------XXXXXXXX-----------------XXX---------XXXX--X---|--|----|-T----XXXX----------------|-----------------------------f
----------------------------------B-------------------------------------------|-T-----oXXXXXXXXX---------------XXXX--------XXXXX------|--|----|-|--XXXXXXX----B----------|-----------------------------f
-----------------------------------------------------------------------o---B--|-|---T-XXXXXXXXXXX------B------XXXXX-------XXXXXX------|--|----|-|----XXXXXX--------------|-------------T---------------f
--------------------X---------?-------------------------??????----------------|-|---|XXXXXXXXXXXXX--------?--XXXXXX------XXXXXXX-----o|--|----|-|-B--XXXXXXX-------------|-------------|---------------f
m-----------------------E---------XEXXX--------------------X--------X---------|-|E-E|XXXXXXXXXXXXXX---------XXXXXXX-----XXXXXXXX-----X|--|----|-|----XXXXXXXX------------|-E??--------?|?E-------------X
XXXXXXXXXXXXXXXXXXXXXX-------------------XXXXXXXXXXXXXXXXXXX?XX----------?XXX-|X|--X|XXXXXXXXXXXXXXXXXXXXXXXXXXXXXXXXXXXXXXXXXXXXXXXXX|XX|XXXX|X|X--XXXXXXXXXXXXXXXXXXX-X|----XXXXXXXXX|XXXXXXXXXXXXXXXX
