----?-?-----------------------------T--E-------------|--------------------------------------?-o-----------------o--X----------------E---------------T---oo-----?-?--T-------?---X-T-?--EB-----B-E---M?-M
--T---------B------------B----o------------------------|--------------?------------?----o------?-------oT---------------?--B---|--------X------E----?-M--o--o-------------oE---B--M--------------B-----|
---M-------?----X-?-------T----------T--?------------B---?--T---------|-------------E-------------T--M-----X--E-|?-T--?------?-X-X-X--------------o--M--?-|-----------X------------------o---------T---T
--------E---------------T------T------T--------------T---------------o---X--------------B-----E-----------------------------|------M----T---|-X---------------------------o-X----------E----------X----o
-------E------?-|------B-|-----?------------X----------------?--T--o-----X--------------?-------|-------------T------------------X-----E---------------B-X---TT---o-E--|----------|-------------T------X
------|-------------------TB--------B---Eo----------B------?-----|M------M--X--------X------------------?-----E---------X--X--------|----E---------E--XM----T--------------E----?------------X-----|---E
--------|---?-M----X|M|------------------X----X------------------------------------------X-----------M-----T------X-B---------------|--|-?----------?---------M---|E--------|---?-----------------X--o-B
---------------------X-------------EB---|------MT-X------------M-T-------|------E--------------E-----------------------------E------M---XE--------M--M-------?T---o-----------B------|T-----|---------vE
-?XB----E-B-oT--BT----------X?---T---XXTB--------M-X---B-?T----?--ET---B-E----|---T-----X--?X|-E---TX-----T-M--T-T|-------M--E|T---oo---o-X-----B--------o-XX----?T-E-|-||-?--------E-B-XE--M--MMoMoE-f-
--E-XEB--TBE-E---T-----B?X--TE---XBE--BM-?-----T-Bo|E--|---E---X-o-E-?----------B--M----X---M--|-?M-T-||-----MT-o--?|X--M---T--TT--B-oMMT----o?----------o---B--T---M----M|---B---B-------?-|-XB------fB
-?-B----ET---|o----o--X-BB-------|--E?TT----MT---||-o--M-?-M?||-BoB----X-B|oTE--T-T?ET-|--------------B--T-T--B---T--X-o-T||----?--?-------------|-B------?--MEXMXX-?-BM-|------|X---B--B--EX|XE----?Efo
---X|EB---|X------E-M---E-TTo-BM-X---E-T-|-?-----T--o-----E-X-----?---|M-M--|--?-T?X--T|-o------||-Xo------X-M--B|B----M-T--|T--B?--X-|-M----------E--?----|XB-o-M-X-?EM---M|---BB--?---B-?--B----XM-Tf|
--M-------Bo--T-------X-oM---------o-------o--oM---X----M-T|------E-M--o|--M---|TE----T|o---?--E-B--B-T----o|-X--|o--?------|o-?---E-B----?-o|-o---o|-?TE||oT---X--B-------?M----M-?T---E--T-EE?T---X-fX
---BT-o----X-M--?---M-Bo-XTE-------|--o?-?-T---------o-TX--|T-|T---M----T-M--MTT-------T---------XTo---o?o-------BT?-??---------X-M-|-o-X?-MME-------------------B-------X?-----M----o--?----BE--E-X--fE
m-B|-------XM----?E-T---|TX--B---E----?----?XEX----B----MB-X---?XE-|MT--EEB-o-?----o---?-o---|--B-XB----oE---------B-T---Eo--X-----MM--??XXE-||M---B-M----X---------T|T---X|-|T---X--B--T---X---oT--oB?M
XXXXXXXXXXXXXXXXXXXXXXXXXXXXXXXXXXXXXXXXXXXXXXXXXXXXXXXXXXXXXXXXXXXXXXXXXXXXXXXXXXXXXXXXXXXXXXXXXXXXXXXXXXXXXXXXXXXXXXXXXXXXXXXXXXXXXXXXXXXXXXXXXXXXXXXXXXXXXXXXXXXXXXXXXXXXXXXXXXXXXXXXXXXXXXXXXXXXXXXX
