--------------------------?-oE----M-------------E------B--------------E-------------M-------------B---------------?--------------B----oX---M----E---B-E------X-----------?o-----BB----------------MB----
--------------E----------E------M----------------------M?----------X-------X---------o---------B-B-----------------ME---------------------------------EM-----E-----M--?-----------------o--------B---M--
----X---o----o---------EX-X------?---?---------o----X-----?----X-------B--------------------?BE---E--M--B---------------o------------------------M-----M--------B---?----X--o-o---------------E---B-----
------X-------------------------------B----M--?o----MB-o------------XM---------------------------M-----?---------XE--------?M----X--------M-----------------------B-o---------M------------o------------
-------?-----B--------------------M---M----------o----M---------o-------------Mo-----o---M-------------o---------o-----B---?---E-----E--------B---------------------B----------o-B----------------------
--X--------B-----B--------B----------------------------M--------o--------E---M-------------------?--E--o-------------EX------o--------------X?-----?----?---E---------o--------B----------E?-X------?---
------?--X----------------BE----B-E---?--o----?-----M-----------B---------------MX--E---------------------X-----M--Eo------?-Bo--------------------E--o-----BM-----?------------------------B---M---B---
-------------------M---o-------B----------M---X--------------X----------Bo------M?---------------Eo-------------------------?------------o---------------M-----------M--------o----E-X----------------v-
-XE-------?-EE-------------EE---Mo--Eo---------XM-XM---E-o-o-----B-EBE---M---?--B---ME--------o----oBXM---M------B-----E-???Xo-XX-B----E--M------E-X----XM-M-------------?----X--X-M---B-E-B---M?-X-XMf-
---oB--oM---EE-MM?--B-o-B-M-M--M--------?----o?---?-X---B---oB-o---X-----EE-X-------Eoo--B---------XoB---------?---------MB?B----?--Bo----------X-X------Mo-oE---M?-M---?-M-?-M-o--------M------------f-
-o---o---------E--M--?M----E?-B-BX------E--M??M----------E-??-E--E------------X---------B-E---?B-B--------?---Mo--X-------B-----B--?--------------?--E---------------M--B--------B-----Mo---B-M-------f-
-X-------M-o------B----o-----o---?------X-E---X---M---?------X-----XE--M------?-----------?-?-E?M-Eo--o----?--E-------------o-M--E---oo-o--E------M---X---------o-E----E-oE--??---o-BE--B----------BB?f-
-----M--X----BB------------E-ME--X-----B---------BB--M--X-E?------E-E-o-B-X--oo--?-?---EE--------E-o?--?---------E--X-B-----B--B---------------EoEB--------B-Bo----BM-o---B-o-M---o--E-M----BM---E-M--f-
-E----?------E-----T-T----T---B--T-B---o-MMM-o-B-To--XX?--?EM--MMT--T---T------------------------X?--T---XE?--T-B--------EBX----------o----T-o?-M-TMEB--?-------T?-TT----X-?---?---o------X-----X---?Ef-
m---o?----?-T-BXX--|||----|M--BM-|-T--E?---T|--B-|MT---M-B?X-----|-E|---|---T----E?B---BB-?---B-----||-B---E--|----T-T-------T---EoE?|XX---|?--X-M|M--M-T-----MT|--||-------XB--oM----------o----B|EX-f-
XXXXXXXXXXXXXXXXXXXXXXXXXXXXXXXXXXXXXXXXXXXXXXXXXXXXXXXXXXXXXXXXXXXXXXXXXXXXXXXXXXXXXXXXXXXXXXXXXXXXXXXXXXXXXXXXXXXXXXXXXXXXXXXXXXXXXXXXXXXXXXXXXXXXXXXXXXXXXXXXXXXXXXXXXXXXXXXXXXXXXXXXXXXXXXXXXXXXXXXX
