---TX---X------X--M---------------o------------------------B---o-T-o-----E------X--------ooE--E-------E---|-o----------------B-----------M----?----------X-----M-TX?------------E---?--EB-----B-E---M?-?
----|-X-----------|------B---T---------------M-TXX--|--X------------o------------------M----T----------------------B--T-----?------------------|------o------|B-------|--------------|-----------B-----|
-X------------------------T-----|------------------------------T-----?-----M-X--T-----M----o----------?--o----E-|------------B------------X--?-----------------X----T--------------------o---------T---B
----------------?----------------------------X-|--?------?-------|M------o---------------T--o--------------?-?--X-----|--------X--------T---|-X---------------------------o-X----------E----------X----B
----|X-MX---------X-------------X-----o---------------------T------------------T---------------|-----M---------------B----------M------E-o---------T---T----E-------------------T----------------------X
-B--------M----o----------T---------B---Eo----------B------?-----|M------M--X--------X------------------?-----E---------X--X--------|----E---------E--XM----T--------------E----?------------X-----|---M
-----X----------oE-------X------------o---?--B----?-----T--------------?----------o------X-----------M-----T------X-B---------------|--|-?----------?---------M---|E--------|---?-----------------X--o--
--B-----------------o--------------EB---|------MT-X------------M-T-------|------E--------------E-----------------------------E------M---XE--------M--M-------?T---o-----------B------|T-----|---------vE
-----X---------?T|?--T--B--BB--X--M---X---------o|-M|B?---X--------E--o-X------X-?--------E-T--XTo-o-T-T-B--TT--E--EM--X--|---oM-------??-?----MTB--------E-E-EBX-------T--|EEE?----E-B-XE--M--MMoMoE-f-
-EX---TTX--o------|---M-?------oX----o--B--EM-M-M?-----M--E---o-BEB|-----------XT-----o----Eo-BXT---T-||-----MT-o--?|X--M---T--TT--B-oMMT----o?----------o---B--T---M----M|---B---B-------?-|-XB------fB
-X-M---?-M--------MoX-|--------?|-B|XX-o--TB--T|X-oX-|----|--T-------|---o------|-M---oT|-E-EE|B-X----E-E--T--B---T--X-o-T||----?--?-------------|-B------?--MEXMXX-?-BM-|------|X---B--B--EX|XE----?EfM
-B-TX-----T-M----M---E---EM-B?X-o--M-|--B--TB-|--E--TEXM--B?-XBo--||-?----T-----??--M----T-T?-------E-BT-----|---MTT-T-T--?o-----|---X---?-o---?--E--B?----|XB-o-M-X-?EM---M|---BB--?---B-?--B----XM-TfX
-----|-o-o|--------B-E-E-X-X-T---?--------MM|E--M-|--MXBBBo--EM-T|---T--------MX--E---X--BM-|-T---E--E-|M|-BBMXM-T---B-B----X--XoX--------ME---?o-oM---M-M-|----X--B-------?M----M-?T---E--T-EE?T---X-fT
-|To----T|-T---T?X------M-|--B-----|--o?-?-T---------o-TX--|T-|T---M----T-M--MTT-------T---------XTo---o?o-------BT?-??---------X-M-|-o-X?-MME-------------------B-------X?-----M----o--?----BE--E-X--f?
m-M-TB----?---o?MBo-------?To--|oE?----?------T---o|---M--------E-X--T---T-|-|M--o----T-?--?-o-|--|-----oB-TX-?X----?---oT---X-----MM--??XXE-||M---B-M----X---------T|T---X|-|T---X--B--T---X---oT--oB?T
XXXXXXXXXXXXXXXXXXXXXXXXXXXXXXXXXXXXXXXXXXXXXXXXXXXXXXXXXXXXXXXXXXXXXXXXXXXXXXXXXXXXXXXXXXXXXXXXXXXXXXXXXXXXXXXXXXXXXXXXXXXXXXXXXXXXXXXXXXXXXXXXXXXXXXXXXXXXXXXXXXXXXXXXXXXXXXXXXXXXXXXXXXXXXXXXXXXXXXXX
