--------M----M-E-----?------E----------T-T-----o-------MM---M------TE-------------B---------M---------?-------------X---|--??B?-B------o-?-M------X--------X---------------E--------------------X?--M---
-ET--E----o----------------E--T-------B?---?-----------o-----|-----T-----|--------X---?-----------|--B--------o|-?--------E----?-----M----o----|--------?-------T-X---E--|-??-----|---------|------|---B
---B------o------------E---B---------X-E----o-------E-o----E|-------------------|--?E------|-----------------------?-M-----------o---o----?----------------------------B|-T--------------BB------------T
----------------M---o--------|-|o-----------------T-----To------------o-T-----------------XX------M--|B---?-------------------X--------------o-o|T-T-B----------E-E------oM-M--T-----o------E----------E
------|--B------E-o----------E--E----B-------------o-----------M--------B--------B---------|-----M-?---------------B-----B----|-----------?--------------------------------EE------TB------------------B
--|---?-----X--------B----------------T-------EE------------------------XB----------|-----?-------X-------------o|----T----TBB---------------M-----------------------------|-----------o---------------E
-----o-----E-E---o--?---E-T--X-----B--E----ME-----|E-------------------------T--?------------E--M---|-----o------------B-E---M-------TM--------o-o-B---E--T--M-------------------------------------o|--|
-------------X--------T----------------|---------------B------M--------X----------------------|------M-----------------------EE------X----?-----M-|--XT--B------------------o-----X------------XE-----vT
------X----|-EXM-T|-T-|--------|E--?--T--M---E---|----|--|----Mo-Eo--X-E-----------E--E-|----T-M-o-T----|----EB-----X---T--B-EM----M?--M---X-T|----T---T-----X--X-X------X-ME-------?o---B-M---M--B|--f|
-?-------T--XM-T|X-----|-------BTBo|B?--|?|oEE--EoEMX-------B-------T---X----TE-XM---EE-M--XM-?-----------?-M------Eo-E---E---X-T-----EM-X-E----B--Mo-E-M--E|-o-o-|-XE---E----?-B----T--TXE--M-E-B--BBf?
----X----MB-M-M-M-X----|-----o|-?---?|--oT--XEB--B-TM-|--T-o--|X-M---M--M-M-o----BM--------Eo??---M-----EoT-XB-?--T|?-o-E?-E--M-E-----MT----X-E---XMBX---|-?---T-------M--XT------M---M----oB-T----T-MfX
---B-ET-----------B--|-X|-EM?-M----|E----E--?X--?EEo-|T-----BE--T--|---o--|Bo-ET?--|----|---B--M|-BXX--o----EMB-----------|-M-----E----?E??X--X----M-------MBX--o-X-?-?-E-M-----X?M---|M-B-M?E--B---M-fX
---|-T----?--BB-o--M-B----T-|B----T---o--o---oMB--MT-|-------B-?--M----B-?----??--BBE-------M-X--E-BXo--B-|?----T|X------|-?------B-|--X-----?-o---?-E-E-X--X---------X|M---XXX--M-o----|-Xo-E?-B----Bf?
---EX---B-?|-----E--Xo|-T---E----?-?T--E-E---To--?-----o---E|--M-------T---M----E-----M-------Mo----M--EX--|-|---B-XT-B--TM-|--B-T--|TE|-------|-X-B-B-?---------X---To--?E--M--Too|--TTo-B--------|--fX
m---T----X----?----T--?-?--------B||-|--T--T---o----o-T-----B?--E--T--o-?-B--X--M-?---T--?T---To--|--M--E-oB---T--E--MMT-|-|--X--------M|XT-------|---E-EM-XT--T--T---T-B-o--------M-?oB|--|--X--------E
XXXXXXXXXXXXXXXXXXXXXXXXXXXXXXXXXXXXXXXXXXXXXXXXXXXXXXXXXXXXXXXXXXXXXXXXXXXXXXXXXXXXXXXXXXXXXXXXXXXXXXXXXXXXXXXXXXXXXXXXXXXXXXXXXXXXXXXXXXXXXXXXXXXXXXXXXXXXXXXXXXXXXXXXXXXXXXXXXXXXXXXXXXXXXXXXXXXXXXXX
