-M-----------E-E-------ET---E----------?-o-----------o--?-E--o-X-------B--------M---------?-----X-----|?B-----------M-----------------------X----------------------------------B-------oT-------E------X
------------M------------EX-------------?---------B-----M----|-------------------------------|--------|----?--------|-o------B---?------M------X-B--|M---o-|-------X-------------------------E---Eo----o
--------X-X---X--------|-----M---TB---X-----------------o---------X--------?----X------------MB-----------------T-T-----X-M---E-----------------o-----------------------------|-----------?--B---------M
------B-----o--------------------------E--?-T------------------------|-----|---|----M|-------------------------------E---T---------------|-------o-----?B-------T---------M----------------E-----T---T-?
-X----------------------M----o----------------T--o---------------------------XB------?---B--T-----E-----X----E--------------TM-----B----M---------------------------?----------o---?-------------------T
---T---B-M---E-|--?-?----|--------------------------?--------------X------------------------B-----B-------B|--E--------------------M------o-----?---------------------BE--------------------E---?------E
-M------------o----------B------?--------T---------------o-----------------------------BTMM-------o-----------------B-------T---|----X-T-------E----T-------E---E------------M------?--------------o---X
-XE------------------|--------E-?------o---o--------E----|-EM---------?E--------T-M-----------M--------------------------------------------TT-|-------------------X--------------o-------------o------vE
--E-|--oB-|oE--X-----BB-----EX-----X--?E-EX-M-----o----------B|-M-E|-----B-E?--o-|T||E--?-o-E--BB-|?-M-M-------B---?M|-------M------E---------B--X-?XM---T-------------TBM-B-----M--|---E-M-?----|----fE
-M-o----?E-T----EE-------X--?|----?T-X-o--ME-MB----M--E?--o-----X|XB|-T------------|?|-T--BB-M?------------?---oE----oX-E-?--M|-|-XTMT----B---MoX--B--XXB--X--E--------E--------|------M-B-?-o-M-?X?--fM
-|----|-----B-TM-M--------------?----E-?-----o-M?T-M---M--B-----?-M-M-?-----X?-?------|B--?--?Eo-----B-?M-----?E-------------o-?--E-X----B------MB--T--Mo-------o-T|?M|MT--EM----X|-EE|-T----Xo-E-B---fX
-?-o-B-ETT---|----|-|BM----|B---?--||--M-XX----X-B--MX-B-E?------ME--?---??--------------|T-?---|------?T-----T-----XE------M-|B-T-------o--|T-----M--EMB--|-?-------B-o|-----|B--B----T---X|--X------fE
---o----TET--?--B--T||?-|---o--?-----o----?-----X---T--BB---X---?||-B-X----|-X-B-||E-----M-B----T??E-M--X--BT---EB?---|E--T---??--Xo---|----B-M--?-M-?-B------B-M-?E-B---o-----------------M-X--E-EM?-fB
--------o|--|--o---BB----X-T?o|-E-?E-B---B?|o---------B-E-BEM------X---?|Xo---X-M----E?--B-o-M?---BT-EB---E--MT-------------XE-E--T-----T----X---M------B|--ME-o-X--?--?---XE-o--B--?o-T------M--o---XfT
mT----------|---------B-M-----T--|-BM--XT-?----?---E--X-------o--E-TEBT-----------X-M-o?--B---------------|--E---X|-|-------------|----|-B?-|-T------||X?-M--TMM-?---|o--?o?------|--ET--X?-T-M-oT-B-T-M
XXXXXXXXXXXXXXXXXXXXXXXXXXXXXXXXXXXXXXXXXXXXXXXXXXXXXXXXXXXXXXXXXXXXXXXXXXXXXXXXXXXXXXXXXXXXXXXXXXXXXXXXXXXXXXXXXXXXXXXXXXXXXXXXXXXXXXXXXXXXXXXXXXXXXXXXXXXXXXXXXXXXXXXXXXXXXXXXXXXXXXXXXXXXXXXXXXXXXXXX
