----------------------E------------------------?-B-------------------------------------------------------------------------------------------?-------?----------------------------?B------?--EM---------
-E----------o-----------------o----------o---------------------------------E-----?--------------------------------------------------------B---M---------------------------------------------------------
-------------?--------oM---------------------------------------------B--------------?---M-------o-----o-------------M----M------------------------------------------------------------------------------
------------------------------------------------------------------------E------------------------------?--?-----?---------------------------E-------------------------------------------------------o---
------------------B--------------?----B---------E-----------o------------------M----------B-M------B-------------B--B-----------------------M-------?------B--------?-----------------------------------
----------------M-E--------------?-------------B----------------B---------------------------o-------------------?-----------------------o--------E------------------------------------------------------
-------------------------------E-----M----------------o------Mo--------?------------------------------------------------------------------o---------------------E-------------E-------------?-----------
--------------------------------E--------------------------------------------------------B----------------------E--E------o------M-----------------------------------------------------------M-B-------v
---?----------------------------o-------------------E---?----------------------o-------?-------------------M------?------------------------------------o--------------E--B-E---------------------------f
---?-----------M--------------o----------M--------B-------------------------o-----------------------------------M--------------o-------------M-------------------------M----------------------B--------f
--------------o-----------M---------------------M--------B------------o----------------------------------------------o------o------------------------------------B------M------------------------------f
---?---------------------E-------------------------------------------------o--------------------o--M-----------------------------------------?------------M------------------------E-------------------f
--EM--------?----o-----T----T--------------------o--B---E----------T----------------------------------M-------------------------------------------B--T--M-B-T----------------o-E-----------E-----------f
----------T-----------T------o--------------------------T----------|--T----------------------T---T--M--------T-T---------T---?--------------------T---------|-T--T-------------E----------T-o---E------f
m---------|----------?|--------------?---------B--------|-------?--|--|----------------------|---|-----------|-|-------M-|o-----------------------|----?----|-|--|--------?-----?---------|------------X
XXXXXXXXXXXXXXXXXXXXXXXXXXXXXXXXXXXXXXXXXXXXXXXXXXXXXXXXXXXXXXXXXXXXXXXXXXXXXXXXXXXXXXXXXXXXXXXXXXXXXXXXXXXXXXXXXXXXXXXXXXXXXXXXXXXXXXXXXXXXXXXXXXXXXXXXXXXXXXXXXXXXXXXXXXXXXXXXXXXXXXXXXXXXXXXXXXXXXXXX
