-B--T-B--------T------|---X---X-------B--T---------X----B-TBo-T---------------------------o-M---------E---------------------------?-------BE---------B------------?-|--------X-T--------------M-M-------
--------------------------------MX-----X---M--------------?-----------------X--oM----------o--T--------E-|--------X----E--B--|-B-M----|X---------E-M--?----------------------X----B-------MT--B--------X
----X-T-T-----T--X-----B---------------X--T----B--B-T-------o--BE-------------|----XE-------------E-----Bo-----X-?------|-------------B-----?--B--?--------------------o-------------------------------o
---?T---------------------T--X-------o-----?---------------|B---oB-------X----B---Eoo-------o|-X-----------------------------------B-----|---B-TT---M-----o-----------T----M------------------E-o--B---|
------E------------X---------------X-------o-----T--M---B----------------------------------------|T---E------------------?--M?-----------o----|T----B---M-B-----------M------------?o--------X---------?
---------T----oB--------XE---M-----?--------------?-----------------------------o--E--E---------------E--------B-|----X---o--T------MM?--?---o-?-|-----------------o-MM-M-----------o---------M|-B-----M
-------?--o-EM---B---T--T------E---------------E--o---------BE-E-------------------------------XT---------|-------------M-?----M|-B---X------------?-------------?---------T-------T--------------X----?
------X---------------------?---o|X--E--X------------MM------B-----------------?----M--------E-B--T-------------------M-------|-o-------------|--o--------------------------E-------------B----X--T---vB
-o---E---|?-|TB-M-o-X--T-M----o-------|-E-?E--o-o-----o---Xo-|---E-----MM-o-?--E-T-|-o---T?E----X---o|-M------o--------E-X-----T---T---?X-|----?----M-X----E?---|--|-B-EE---------o-oB--|-T---M--EE---f|
--|B----B-----o-XE-?-|-|MX------E-B---B---TBXTBM------EX------oX----B-T---B--X--------|BE-T--|---o--------B-o?-MX---TE-|o---X-T---?----o-oB--B--XE-----o--TB------------T--o--E-T--------BE--M?-XT?TM-fo
--EX|?E----?o-----oT?Xo?M----E-|-Bo----E---------BM-E--E--o-o--B?-M-o-M------|--T-o----X--M-E-M??--TM------oEX?|E-----MM|MMo-M-X-?-E|T|B--------M--E---?-XE-o-MB|?-T??--B---T-----BM--XB?----BE-EE---Mf-
-o---------|---------------|X-oM---?--M--Eo-?--?-----T?E-|o--M----B----TBT--|--Mo--X--?--B-----??-|?-B----T--Eo-o----E--M--BE--B----E?M?----B-E---B?----?--X-B----X-|XX---o---XXM-M------|BTB---B-BX|-fT
--B|-TMM-----XoX---ooo--B---|--?|BX-----?----EE----TX--M-|--E-----?---X-?B--BT--|-M--MXoX|o--ETE--?X-E----TT-T-T-X---?-T-??-TBB|----|----E--E----E---BXT--B----B--o----BM|-?---T--|-TB--oT-o|-M-----B-f|
----?-B--E--?X---TTMT--o------B---?-M--|---?--oo----?--E--------------E-|-----T----EX---X--------MB-o------?----X----TT-o--T---Bo|-MB---B-|XE--X-B-------EB-E-M-BT-T-B-?-----TM--T----B------B---o-?-XfE
m----o-MME--B----To|XB-----MME-ME-?-o-o---o?---||-MoT?X-|-?--?-----||-T---E-----B---T|-B--oM-M-----M-----T---B-B??--BooE----oM-|-XX--X---?--B-M--XE--TE--|-oB-?|?-o|-M?MT?E-EBE----B|------BM|-Mo--E-oBo
XXXXXXXXXXXXXXXXXXXXXXXXXXXXXXXXXXXXXXXXXXXXXXXXXXXXXXXXXXXXXXXXXXXXXXXXXXXXXXXXXXXXXXXXXXXXXXXXXXXXXXXXXXXXXXXXXXXXXXXXXXXXXXXXXXXXXXXXXXXXXXXXXXXXXXXXXXXXXXXXXXXXXXXXXXXXXXXXXXXXXXXXXXXXXXXXXXXXXXXX
