----T--------B-----X|-o-------------------|-------X--------------------TE--------X-----XE------|---?------------------|------|-B?-B-X-------EM--------X?------T--?----------------|---E-?-T------?-----|
------?---B-----------M-|---E----------------------M?-E---------M---o--?-------B------T---------?----T-M-EM|-------|M-|----------M------M----M--B---------TMT------?M--------------------------B-------M
------------X----------M--B--M?|------------|--------------E--------o-?---------|----------T---------------X-o-----|-B---E--------X---E-|---E--M----|---------M---?-----B---------------------X---?o----
-----B-------------------------?-?------------------------------------------?---B---------------B-----------------M---EE--------M-o---------XB----------M---------?-o---------------MM-----o-----------T
----------------M-E---------------X-----M-E---------|T--TM--------B-M------?-o------T--------o---X------|---X-----------------------o-M-------------o----------?-----o--o----|o---TM--?-----------|----?
----o-?E--B-------------------|----X------E-------------B---oT--X--------B--|----T----?----T--------T------------oTT-o-------o--?-------oM-----X---T--B------------------M--------?---o?---------------X
-B---------------X-------T-------?-------------X----B-----?-----------------------------|T-------------------------------------?--------------oE--------------------------------o--------------------E-M
---o-------B----o|-?----X-B-----B------M---E------------------------------------X--------B--------------T---E-------------|-M-M-------------o------BM-------------?X--E-------------M?----------------vT
-----------------|M-BEB-X-------T----T-?T-------------X--B---o--?-M-XM---X--?----E-TM--T-B--?E--X------?-M----B-E-?---o-E-TM---|---|------T---B-o--BoB---M-E--B-|-?-E--B-B-M--MX--B-o--EB--B-B-M--T---fE
--?----?M-------X-M-|M------BE-------T-?-B--?-M||-B----E---E-T|---X-T-|ME-?-|BX---To----E--E--XTE|-E-E?T-B--E?--BT-XTX-?--?--?--o----B-E--T-E---|---?-X-BoM--M-?T-----?-----ME-M-B-----T-------E-o-TE-fM
--MTX-B--E----------?-B----M|----E-----XX-oM-?---M|---------B--|--------M---o--|-Eo-o|--?-B-Mo-----M-?--|---T--M?o|M-E-?----B?o-B--MB|-|------X-|--------B--E?E---TE--?--X|-?--?-X-B|---?BoT||-E-E-X--fB
--MTX---X---X---|E----E-|?oBE--E---oM-BXM-|------|E-M?T---|--------T-EBM-|-X--------|--ToX--M--------?---E--M-X|--B-?------B---T|---M-?---E?-TE-B--E----?-|o-E--o-T-E|---T-o-X---?---------MTM--|----?fT
-|E---E?oB--|?-TB?--o-------E---E-----o|------X--X--T---?----M-----E-|?--E-------o----|M|---B??----oB------o?--XX---T-T-o?--------?--X-E-o---|ME------B-o-?|--?---o-|-B?----T----To--X--T-?--M|--?--?-f?
-T---E-|-XM-----ET--X----BX---E-BBX---Eo|--XX-M---|-------oB-----MX---BE---oE----B---M---X-----B--X-T---TX|----?TEE----M|-T-oE-|o--MBM--EE-XM-M-B---E--o---XX--X?----o-T|---------T-X--?---------|---Tfo
m---oT-T-E-o---T------|--oE-----|--ToM------?----------M----o-?----|-X--To---------?-----|-TX-E-------o-?--X---oX------T----E-?-----M-TXE-E-T----X-----|--MT----??E-EM--XT-B------M-------X-?-E-E-?-?E?M
XXXXXXXXXXXXXXXXXXXXXXXXXXXXXXXXXXXXXXXXXXXXXXXXXXXXXXXXXXXXXXXXXXXXXXXXXXXXXXXXXXXXXXXXXXXXXXXXXXXXXXXXXXXXXXXXXXXXXXXXXXXXXXXXXXXXXXXXXXXXXXXXXXXXXXXXXXXXXXXXXXXXXXXXXXXXXXXXXXXXXXXXXXXXXXXXXXXXXXXX
