------------------------------------------------------------------------------------------------------------------o---------B------------------?--------------------------------------------------------
-----------------------------------------------------------------o---------------------------------------------------------------------------------------------------------------------XX---------------
----------------------------------------------------------------------------B-----------------o---------------------------BBBBBBB-----------------------------------------------------------------------
---------------T---------------------------------------X---------------------------------------------T------------------------------------o-------------------------------------------------------------
---------------|----------------------M-------------------------?---------------------------------X--|--------------------------------------------------------------------------------------------------
---------------|-------------------------------------------------------------------------------------|--------------------------------------------------------------------------------------------------
-------X-------|-------BBBBBBB-----------------------------------------------------------------------|-----------------------------------------------------------------------------------------------B--
-------XX------|---------B--------------------BBB?BB-o----------------X----------------------o-------|--------------------------------------------------------------?????------------------------------v
-------XXX-----|X-----------------------------------------------------XX-------------------o--T------|---------------------------------------------------------------------------T-----------------X---f
-------XXXX----|------------------------------------------------------XXX---------------------|------|---------------T-------------------------------------------------T---------|--------------------Xf
-------XXXXX---|------------------------------------------------------XXXX---------o---------o|------|---------------|--------------o----------------------------------|---------|-------------------XXf
-------XXXXXX-X|--------------------------------------------------?---XXXXX-------------------|------|-------o-------|-------------------XXXXXX------------------------|---------|------?-----------XXXf
-------XXXXXXXX|-------------X-M-----X----------o---------------------XXXXXXT-----------------|------|---------------|--------------T----------------------------------|-----X--T|--M--------------XXXXf
-----B-XXXXXXXX|XBBB---------XX---------------------------------------XXXXXX|---------------B-|------|---------------|--------------|-o--------------------------T-T---|--------||----------------XXXXXf
m------XXXXXXXX|XX-------?-E-XXX-----------o---------o--------------E-XXXXXX|X----------------|------|----------E----|------E----E--|-----E---E------E-----------|-|--X|--------||--E------------XXXXXXX
XXXXXXXXXXXXXXX|XXXXXXXXXXXXXXXXXXXXXoXXXXXXXXXXXXXXXXXXXXXXXXXXXXXXXXXXXXXX|XXXXXXXXXXXXXXXXX|XXXXXX|XXXXXXXXXXXXXXX|XXXXXXXXX-----|-----------XXXXXXXXXXXXX-XXX|X|XXX|XXXXXXX-||XXXXXXXXXXXXXXXXXXXXXX
