-----------------------------------------------------------------------------------------------------------------------------------------------------------------B--------------------------------M-----
------------------------------------------X----------------X--------------------------------------------------------------------------------------------------------------------------------------------
--------------------------------------------------------------------?---------------------------------------------------------------------------------o-------------------------------------------------
----------B----------------------------------------------------------------------------------------------------------------------------------BBBBBB-----------------------------------------------------
--------------------------------------------B-----T----------------------------------X---------------X--------------------------------------------------------------------------------X-----------------
--------------------------------------------------|---------------o-----------X-----XX----------------------------------X---------------------------o---------------------------------------------------
-----------------------------------------------T--|T-------------------------XX----XXX---------------------------------------o-------T-------------------------X----------------------------------o-----
-----------------------------------------X-----|--||------------------------XXX---XXXX-----------------------------------------------|------------------------XX------------------------X--------------v
----------------------------------------XX-----|--||-----------X--X--------XXXX--XXXXXB------------------T---------------------------|--------------T--------XXX-----------------------XX-B---o---M----f
------?--------------------------------XXX-----|--||-------------XX-------XXXXX-XXXXXX-------------------|---o-------o------------B--|--------------|-------XXXX------------T---------XXX--------------f
-------------------------?------------XXXX-----|--||------------XXX------XXXXXXXXXXXXX-------------------|-------------------------XX|--------------|------XXXXX------o-----|--------XXXX--------------f
------------------------B-----M-M----XXXXX-----|--||-----------XXXX-----XXXXXXXXXXXXXX-------------------|---------------------------|--------------|-----XXXXXX------------|-------TXXXX--------------f
------------------------------------XXXXXX-----|--||----------XXXXX----XXXXXXXXTXXXXXX----????-----------|---------------------------|------------?-|---oXXXXXXX------------|------X|XXXX------------X-f
-------X---------B-----------------XXXXXXX-----|--||---------XXXXXX---XXXXXXXXX|XXXXXX-------------------|---------------------------|------------X-|---XXXXXXXX------------|-----XX|XXXX-----------XX-f
m-----XX--------X-----------------XXXXXXXX-----|--||----E---XXXXXXX--XXXXXXXXXX|XXXXXX-------E-----------|--------o--------o----E----|------------XX|--XXXXXXXXXo-----------|----XXX|XXXX----------XXXEX
XXXXXXXXXXXXXXXXXXXXXXXXXXXXXX---XXXXXXXXXXXX-X|XX||XXXXXXXXXXXXXXXXXXXXXXXXXXX|XXXXXX--XXXXXoXXXXXXXXXX-|------XXX---XXX------------|XXXBXXXXXXXXXX|-XXXXXXXXXXXXX--XXXXXXX|XXXXXXX|XXXXXXXXXXXXXXXXXXX
