-----------------------------------------------------------------o----------------------X---------------------M---------------------------------------------------------------------o-------------------
----------------------------------------------------------------------------------------------o-------------------------------------------BB------------------------------------------------------------
-----------------------------------o---------------------------------------------------------------------------------------------------------------------o----------------------------------------------
-------------------------------M---------------------------XXX---------M-------------------------------------------------------------------M-------------------------X----------------------------------
--------------------------------------------?------------------------T----------------------------------------------------------------------------------------------------------------------------------
-------------------------------------BoBBBBBMBBBBBBB-----------------|--------------------------------X-------------------------------------------------------------------------------------------------
----------------M----------------------------M------------------o----|----------------------T--------XX--------------------------------------------------------------------------T----------------------
-----------------------------o---------------------------------------|------T---------------|---M---XXX-----T-------------------------X------------------------------------------|------X--------------v
-----T----------T--------------B-------------------------------------|------|---------------|------XXXX-----|-------------------------XX--------------------------------X--------|---------------------f
-----|----------|--------------------------------------------X-------|----T-|---------------|-----XXXXX-----|-------????????----------XXX-------------------o-----------XX-------|---------------------f
-----|----------|-------------B---------------B-------------XX-------|----|-|---------------|----XXXXXX-----|----------------------X--XXXX------------------------------XXX------|-----------------T---f
-----|----------|-------------T----------------????????----XXX----T--|----|-|---------------|---XXXXXXX-----|---------------------XX--XXXXX---------------------------??XXXX??---|-----------------|---f
--T--|----------|-------------|----------T-----X-----X----XXXX----|--|---?|-|-------------?-|--XXXXXXXX-----|---------------T----XXX--XXXXXX-------------B--------------XXXXX--X-|-----------------|---f
--|--|--?-o-----|-----------T-|-??-------|-----------XX--XXXXX----|--|----|-|---------------|BXXXXXXXXX-----|---------------|---XXXXT-XXXXXXX-----------X---------------XXXXXXXX-|-----------------|-M-f
m-|XX|---?------|-----------|-|------E--E|-----------XXXXXXXXX----|--|-E--|E|-------------E-|XXXXXXXXXX-XXXX|XX?--E-----E--E|--XXXXX|-XXXXXXXX----E-----XX--------------XXXXXXXX-|-----------------|---X
XX|XX|XXXX?XXX--|-XXXXXXXXXX|X|XX------XX|XXXXXXXXXXXXXXXXXXXXXXX-|XX|XXXX|X|XXXXXXXXXXXBB--|XXXXXXXXXXXX---|--XXXXXXXXXXXXX|XXXXXXX|XXXXXXXXXXXXXXXXXXXXXX--BXXXXXX----XXXXXXXXX|XXXXXBXXXXXXXXXXX|XXXX
