----------------------------------------o?---M---------------------o---?-------------------M-----E--------M-------o----oX--------|----|T---------M-o----|-?-X-o------?---M----T-----M--------X---X-----M
-E-------o------------------E--------------?--E---?---E--------|------E----------------E-o-----------M-|-X------|------?--M-B-----------?X------o----------E------T--------EM---------------|----------?
---MM-----------------T----------------------------X-o--o---------------B|-----------o--B---E-------------Xo-B----------------?--------------?-o--M-|-----------------E------------M-------T-----------B
--------------|--o----------?-----------M---B----T----------o-----------------------------------------T--B-------M---?------------------------------------------------------B-------E------------X-----T
--------o-T-----|----------T------------M----E---o--o-----------------T--?------|-----M---Mo----M-X-----------MX--X----B---?------------------T---M--X-M-------------------M----B--------------o-M-----B
--------------------------??-----BX---|-----o---------------?----|---X-o----o------------T--T-E------E----------E----X---E---T--------M----T-M---------|---?-----M------T--?-----o--o-B--------------E-|
-Eo-------M--------------X-M-?o-o-----?-------E---?--X-T-?--M-E---T-------TX-X|----------M-------o-X----o---------------X--o-------X----?----X-------o---------------------o--|-------To--T---------X--E
-------|----|-------|E-----?---B-----------------T-----------o-----E-----------------T--E-----------------E--B--BT----X-------T----B-|---B-|---------X-------------B-----|-----E-E---X---T----------E-v?
-------BX--------|----X--E-----?----oEEX-------T----?---E--?----T-E---|-?B-T-XX-oM--X--oX-B-----o------------|M-EM-------?oE----T--E-|---E--X-TMM---MT---------ooM--X-------------o--M|--BE?ME|B--T--MfT
---XM---M---B-|B-|X--M-----?XT|-XT-BMB---o-BB--MBE--|M|-|-|----M-XB---o--|-----oM----M--------ETX---E-----E-To-EMo-T---E-MET-||-----o|X---E-?-X----B-?o|--?---EBE-----------------M?|X--EMXX--B-T-----fo
--B-X?-EM|T--M---B-?--|---MT-|X--M|-|----|-----|M------T|--------|-B-|B----|------M---------X|o----|---o-EE-T-------B-----X---TM------X---?-E?-----|-|o-E-X---E|--MB|X---o---E-X-----M--TX-ME---X--B--fB
--MEE-M---|EBT-EE-|--|----??M-?-o|XE-------------|--------o--E--E--------M-----T--|-oE|------o-X---B-------B--T--X--E---T----o-E--?E-T-M?----E-|-----M--------M--E-----To---BM-TT|--|oo-|--M----E---M?f?
----Mo--X?B--o?BB----o------B--B-o?----MT-|---------XX-X-X--B?-M--o--MM-------?----oM-X|-----T-?-TM---o-----T------ME-M--B----??--o--|---E----TE--T----o--------X-------E-----E-EM-----o|B-?T--TB-?---f-
--o-||------E--|-|-BBM--oT---------|-B----BT--o--o------E-E-BX-?-o-T-M--T---M-X---To-----MTX-----X-|-BBE-X|-E---XTX---------o-o-o---E-------|-oMo------------EoEB---E------B----?-?E--|----oo-X---o-T-fB
m--?B--T-----------o---E------M-T--o--M?---M?-T---|-M---oM|-o----o-------o---E-o-MB-E---|----?-MB---M---M|----BEMT--oo-|-M|MM--?Eo---o-|---?X-----M-T-M--T-XBB-T----?o-?-|-E--E---E?|----o|-M----TTT---o
XXXXXXXXXXXXXXXXXXXXXXXXXXXXXXXXXXXXXXXXXXXXXXXXXXXXXXXXXXXXXXXXXXXXXXXXXXXXXXXXXXXXXXXXXXXXXXXXXXXXXXXXXXXXXXXXXXXXXXXXXXXXXXXXXXXXXXXXXXXXXXXXXXXXXXXXXXXXXXXXXXXXXXXXXXXXXXXXXXXXXXXXXXXXXXXXXXXXXXXX
