--------------------X---?M---------o------------------------X-?--------B--X----?-T------------------o-------------TB--?---------------------M------?-E----------------M--MBE--T---------------|---T-|--?
-T--------------------?-B-------|-----E|-------E---------o?-----------E--------T------X-M--------?-----------------M--?-B|--?-----------M-------B--?---------B---M-----------------------?-|------o----T
---M--------------B-----E--------o-----------------E--------T-----------?--------------?--?--------|--o------------?--o-M---?----------------------|---EET-X---------------o-------|-|X--------------E-E
----------------B----X-X-----------M-------E-o------X----?B-?--------------------------------------------o--?-E-------------B--------B?-------------o--------------------------M-----------------------X
-----B------?-----------------------?---T------------?------------?M----------------T----------M----B-------T--------------------------M-------------M----E--------TM-B-T-------------B------X---------o
-------?------X--------B------M----------------------------?T|--------o--T------E-T----MX-XM---X--|-X--MX---?-------------?------|----------------?------M-----|-M-------|----E--------------E---------T
-|-------|------------M----------M----M-T-------------------------|---------------------------M---M---T--E-----|-M-------------E---E---o-|-o--X--------T-?-|------T----?--?--------?--o-|--------------?
---------------T---------------E-----------?o--X-?---|----B-------E-----------------------|----------?-|------------------------o---------M--------M---------E-o-E--------M--?-------?---------M---o-EvM
----M-----T--X---o-|-----MM-B-X--------T--ME-o----T-|---B---Eo---B-|---E--TEB-X-TM---X-----||T?--------B|BT-|-ET--B-X----M-?---?---E--EB-----T--|---|-------TE-----E-M-??----EX--TE--M---Xo-|--B-T----f|
-o----||-o----E?|---Xoo--M--B---B---TX-?M----|------TE--T--T-?--EX--X-M--Xo----o-M--|-|-Bo--X-----------TX---o-B----o-EBM-o-X-|-|-?--o--X---o-|------ME-EE-|T-?X-----o----M-|M-M-----?ET-oMBX----E----fo
-B------B-MTMB-?---T--EX--B------B------XB-MB--M-oX--?EE---|Bo--X-M-X-?--M--|--|---|-?-Mo-|------?---|?BE---X---o--M--B---|TB?---BB---|o-MoM--o-EB----|o-|----M-B----E----M-B------T-|-?---|?-----E---f?
--?-o--T---o------BMo-----B-|XB------o|--|-----T--E----?--ETM--B-------E--T-B--T--T---M----ToM-|BX--X?|---------o----E---oo--B?B-E|-E--BTX-ETE--X---X-E-----X--------T-??--B--?-------o-T-----Eo-?---Mf-
-o|----ETM--oE----T--TX??---o-E|?-B-M|--oET---BT---X--M--|-MM|-?o----TEE--E---E--T-E-----Xo-??---o------X--?--MX--|--?---ET----T----|----------B---B?--XE--------|--|---------T-|--?--EXo-----|-EX-M-of-
----T---------oX--T-?-|o----------EE--T-?---E-M--X?------oE---o--?---EEo---BB-X|-?--TB---MM-E?-X-X-B---?--|--?--?X---|--E-----T----T--B-?|X---X--E---T-o--M--TB--o-----|B-M?--E----XM-----|B----o---|-f?
m-o-X-?o-?X--??-o-------M-E--oo-------o-E----M-XTE------ET--B-ME-oX----|EMB-E-----?--X-B-M?--?T-E---M-XBMBT-T--X-X|-o----B|ET------------XT---XX?XE----|?-X----?----------??----E---|-M----oB---oT-B---E
XXXXXXXXXXXXXXXXXXXXXXXXXXXXXXXXXXXXXXXXXXXXXXXXXXXXXXXXXXXXXXXXXXXXXXXXXXXXXXXXXXXXXXXXXXXXXXXXXXXXXXXXXXXXXXXXXXXXXXXXXXXXXXXXXXXXXXXXXXXXXXXXXXXXXXXXXXXXXXXXXXXXXXXXXXXXXXXXXXXXXXXXXXXXXXXXXXXXXXXX
