--------------------------------------------------------------------------------------------------------------------------------------------------------------------------------------------------------
---------------------------------------------?----------------------------------------------------------------------------------------------------------------------------------------------------------
---B----------------------------------------------------------------------------------------------------------------------------------------------------------------------------------------------------
-----------o--------------------------------------------------------------------------------------------------------------------------------------------------------------------------------------------
-------------------------------------------------------------------------------------------M------------------------------------------------------------------------------------------------------------
-------MM--T---------T-------------------------------------------------------------------------------------------------------------------------------M--------------------------------------------------
-----------|---------|----------T----------------------------------------BBB-----------------------------------T---------------------------------------------------?------------------------------------
-----------|---------|----------|-----------------------------------------------------------------------------X|XX-------------------------------------------------------------------------------------v
----------T|---------|----------|------------------------------------------------------------------------------|---------------------------------------------------------------------------------------f
------o---||---------|BBBBBBB---|------------------------------------------------------------------------------|--------------------------------------------X------------------------------------------f
----------||-B-------|----------|-----------------------------T------------------------------------------------|-------------------------------------------XX------------------------------------------f
----------||---------|----------|-----------------------------|------------------------------------------T-----|-o----------------------------------------XXXX-----------------------------------------f
----------||---------|----------|-----------------------------|------------------------------------------|-----|-----------------------------------------XXXXX-----------------------------------------f
----X-----||---BBBBB-|---------X|-----------------------------|???????------------T----------------------|-----|----------------------------------------XXXXXX-----------------------------------------f
m-E-XX---E||---------|---------E|-----------------------------|-------------------|----------------------|-----|---------------------------------------XXXXXXX-----------------------------------------X
XXXXXXXXXX||XXXXXXXXX|XXXXX-----|XXXXXXXXXXXXXXXXXXXXXXXXXXXXX|XXXXXXXXXXXXXXXXXXX|XXXXXXXXXXXXXXXXXXXXXX|XXXXX|XXXXXXXXXXXXX--------XXXXXXXXXXXXXXXXXXXXXXXXXXXXXXXXXXXXXXXXXXXXXXXXXXXXXXXXXXXXXXXXXXX
