-------------oo---E------oTX------------------------B-B---o-------T--B--------|--T--|M-------|--------------------B-------------B---------------?----------M----?-?E---------------T--B------------?---B
-----o-B--------|--------|T-o----|--E---------------M-----X----?----Eo-----X-----E-------B--------------?------B--X--------------X--------??---E-|-M--------T--------------|-MoE------------X------E---|
------M-------B---------------------|---M--E---------M--E----------X?-----B-M------E--X-------o|--------T--M-------------B-----------------------------------B---M----B-----|-------|E---|-----M-------?
-M--M----??----EB---o------E----?-o----M---------X--------E-------------------------M--Xo------------|---X-------------?-E---|--o---M---XT-B------o----M----------E--T----|--T------------X------|B----?
--------|--------T-----B--Bo-------------|-E--o---?---B-----o-------M-T-----------------------------T---T---------------E--------------M-----M-----o-?-----X----X--------|T-------------M------M-----B-X
--B----o---o-o?------------BM-------E--?|-?----------M-----------Xo--?--EX------------X----------M--E--X---------X--------EE----X------Eo-----E-?---------B-B-----|---o-|--?------B------------------o-E
---------T-TM----B?|-?-B------B-o---M------EE-B----------------------B-------E------|----T---------X--B----------X-o--------B-----T----BM--X-----M-----------B--------------------E-B--------B---------o
----T-----------------X------------------B----X-------------------M--BX-------------E--?-----B----|----------------------|------------o----|--------------------------------|TT----o-T-MM------------MvM
----|-B-M--------E-T-X-|-|---?-XM--B--TMM--|TB----?----B-M------E-------|---------|---MX-?|||--Xo----B---M----TE--oB--T------ET-X|--MM-B-E-Xo-----B-X|B-B--?----?T-o--|X?----M-B?------BX--|T----o---XfM
-------E----To-?o-----B-B----|E-B?o---T----E--MM-ETB----M|-|---|-BXT-M--oE|X--X--||TE?----?---BE----------------oB|-----?|------|?-E-------M--T-o--?------o---?--T-------XXM--M-|E-TME-XEXE------o-T--fM
-------|-?---X-M?-|o-|---B---?|---E---EMM---BE||o-M-------M-BM|--BXX--|---o--MB-?----??---|o---T-T|X-------------?XBTM|-M----EMT?o-E-E-|-?--M-|-?---E-T--|X--|-?---X--X--B--BE-?-M-|T---Mo?--o|-T|----fX
--------|----o-M-X-|-T----o-MXo-B-------o-?-o-MT-----X-?---BoX-------X-oB----X--?----M--|-oM--M-X|--B?oTM|-B--M-?-M|---o?X-??--|T----B?M-E----X--oM-E?----TE---B-M------E--T?-|----T-M|-X?ETM---|-|--|f?
-o----M-------?--?-MM-oM-|-B-B-?---|----|---oB---X--?--o-M-XM-----X--|---EB--E----Xo--E-X-----o--E-|X---------o-TT---ooM-B?-M------E--To---o--?-MXE----Eo?----------TM-------M-oT----|E?-o?---M--BM---fM
--M-------TB--E-M---|--MT---EM----------EXo-BT-E---o---X------X--EM--Xo|-|M--XB-B--|------E--BXTT--------?--E----|------B---|---E--XETT--M-EX----|-TX-X-X?-??-X-----?M-----o--X|-|--E---E---T-X--B-Bo-fX
moMM-----------M--------?-M--oBXB-T-T--ME---|-|---?M--T--T---o-T----?--TMEE---B-o-XBB--|---?|-----T--o-|B--Mo------E-M--?B---B-|M-o--X---??-o----T---M?---T---o-oM--|E----X-o---BToT---Xo-M---BM-------X
XXXXXXXXXXXXXXXXXXXXXXXXXXXXXXXXXXXXXXXXXXXXXXXXXXXXXXXXXXXXXXXXXXXXXXXXXXXXXXXXXXXXXXXXXXXXXXXXXXXXXXXXXXXXXXXXXXXXXXXXXXXXXXXXXXXXXXXXXXXXXXXXXXXXXXXXXXXXXXXXXXXXXXXXXXXXXXXXXXXXXXXXXXXXXXXXXXXXXXXX
