----M----T------M---B--T--------X---------E----------E---?--------B-B-----M------------X|---------------------E?---------T------------|-------------E-?-----TE-TX----------------M-----------------|----
-------X-----------------------o--------T-----o?o-|--M------X---------|----o------B---E-----M-M-------o-----T---?--B-E|E-TB-------B---T-o--|--o------E-----B---------o---T----------o-------------B----X
---E--------------------?--X|------------|----------------------?------?-----?-----o------X-E------------E-X-o----------------T---?----MX-----|--?----------B------Eo--M---------M-----o-----o-T-------M
----------------|---------------------X--------------oB----B----B?----|------|--------?---?----X----M--------------E-----B----------------B-----|------------------------------------E---B-------------X
--------|----|-M-----E---------o----TTM--o------T|--------------?---X-------------B--E---oB-------------B-----X------------X-?-----E----o----E----------------E--------------T-T-o---------B----B------E
--------?-----B-|B----------oE--------B---T-o----B-B-E-----E-------------------E-------?----------------ME-MMX--M-----|-----------B--E?--X-------X-----X-----BT-|--B--------o---X---E-----------o------o
---M---M--------E----T------|B-----------||-------o|-------M-------------T--BX-----------X------M--B-----------X----------------T-----------------B--|--M-M----M-|-------?-----------------|-----------E
---?--------------------X--------------||T-|---------------M-|-------------o------?------------M----X-------M---|----------------|--M-E-----|--M-----------?--------X----M--o------------M------------vo
--------?--EB-----MX|----Xo?----|-B-o--XT-M-TX-o------B--o--?--BX-------------B-?--o?-----E-M------------M|-MB--|E|--X---TXE|-E---Eo--X------?--B----------o-|--TB------ET--B-XE?-X---BE-|----o-B-T---fM
-E----T------X--?X-E-----MT-----------?---------XTX-??-T-T--M-?M--|--T-?E---?---E-|-XX---|---B----?o-o-?--EBB-o----T---M--o?-M--EM?X-o--?M---EX---Mo----X--X-M?T-BE----------|----M|-X-M-?o-?---------f?
-TX---oM-M-------|X|--E-|-?o|--XTME-M|--MEM-|-------------------M---------B-oMEo---T---X---------|oM-T--o-|X-----M--XB--B----E-o--|-?MX--ME-----EBE--B-M-o-------B-------Mo-X--X------o---M-|X----o---fT
-------?ETB-?To---M-T--X-X-X--M--X-------EE|----BM-------E-|------------B-----M--M--M--------?E----To---------o---?o-?------XE--o----|X--?-EB---|------|----------------E--MTE--|-XT--T-Xo-?---|T--B-XfB
-o--E---E------||---|---EB-o----T---oXM|-o---B--B-TT----BX-M-M|M----|?---E-T-o---MX-|-ME-B------?|----o?BEX-B---?-o------X-------T--|-M------M-M|--M-X--T----B---T-E-ET--XoMM---BT---E--|---?---------fo
---------o-X------M-o-|X-TM----|E--TE-------M--------o-B-----|-XT---XMTMT-|-B--o?-|-E?M---M-o-B--oo---M----|---|-M-T-EM---------X------?---?-?---|-E-oX--|--------X--M---B?----EB----X-----E--E-M--M-?f-
m-oE--MB-?-T|EE--|-B---T----o--M-----o-X|X-----?o---MTT-??X--X---|----|MB--M-B-E-E---o----M----X---?oTMo---X---T--|M?M|---E---T---|----T-BM----|---B?T------o-M--TT-E?-T-TM--|---Bo---?T-------EM?---M??
XXXXXXXXXXXXXXXXXXXXXXXXXXXXXXXXXXXXXXXXXXXXXXXXXXXXXXXXXXXXXXXXXXXXXXXXXXXXXXXXXXXXXXXXXXXXXXXXXXXXXXXXXXXXXXXXXXXXXXXXXXXXXXXXXXXXXXXXXXXXXXXXXXXXXXXXXXXXXXXXXXXXXXXXXXXXXXXXXXXXXXXXXXXXXXXXXXXXXXXX
