----?-?-----------------------|----E-o----|--M----------------EX--E-------X---------o-------------o--?----X-------------T------------------B-E--X---------o-----------M-----M------|---M---------?-----M
--T---------B-----|------B---T---------------M-TXX--|--X------------o------------------M----T----------------------B--T-----?------------------|------o------|B-------|--------------|-----------B-----|
---M-------?----X-?-------T----------T--?------------B---?--T---------|-------------E-------------T--M-----X--E-|?-T--?------?-X-X-X---------------M|-----M--M----T----------o-------X---o------X------T
------o--T--E------o------M--------------M-----------------X|-M---------o--E----------oE?---------o-----------B--?-----T----E-----------T---|-M-------M---------X--o-----X-----|----o-----X-T-|--------o
-----T-------------E-M--B-----B-----------------------------T------------------T---------------|-----M----o---------M--------|---?--T--M------B-ET----o-------T------------------------M-|--X-----T----X
------|----------o--E-------------E-B---Eo----------B------?-----|M------M--X--------X------------------?-----E---------X--X--------|------------B---M-------------B-----B------------------Xo---------E
--------|----B---------E-------EB|------T---o--------?-E-------------------------------X------------E---|---MX----------------------X-------T-------?---------M---|E--------|---?-------X-------M-E----B
---------------------X---------B----?-----Xo-----T-----------------------o-------------------M---------B-------oE--X---------------oB---?B--T----------X--M---E||-------------------T----------M?-----vE
-?XB----E-B-oT--BT----------X?---T---XXTB--------M-X---B-?T---XB|E--E----M-EX-X--T-X-TT--TXX--M-E?-TX-----T-M--T-T|-------M--E|T---oo--??-?----MTB--------E-E-EBX-------T--|EEE?----E-B-XE--X---E---XEf-
--E-XEB--TBE-E---T-----B?X--TE---XBE--BM-?---B--M?-----M--E---o-BEB|-----------XTX-|----M|-o--?--o---B-???---X--To-E---X-|T?T------M-||--T?EoBoBMB-B-E----T--T--------X-M-----Bo------B-BT-?T--|-?----fB
-?-B----ET---|o-----E-M-To|B-E------MM-----X|T?o--B------oBX------B----X-B|oTE--T-T?ET-|-----E|B-X----E-E--T--B---T--X-o-T||----?--?-------------|-B------?--MEXMXX-?-BM-|------|X---BM?-?o---o----T--fo
-?----BX-T--M--?-E--T|--X----BEMo--M-|--B--TB-|--E--TEXM--B?-XBo--||-?----T-----??--M----T-T?-------E-BT-----|---MTT-T-T--?o-----|---X---?-o---?--E--B?----|XB-o-M-X-?EM---M---B-T-X---oo-----T----X?-f|
--M-------Bo--T-------X-oM---------o-------o--oM-X-?-M-----EE-?X-o-TT-----E-------E--o-B-M---T---o---o--X--o-T-M-??--B-B----X--XoX--------ME---?o-oM---M-M-|----X--B----X--o-T----oMXMEX-|XET-X----|BEfX
---BT-o----X-M-B-X--T?-B--o---B-o--?--B---TT---E--?--X-BT----XMX?-BB----|-------BoX--TM-------------------|----?-M----E-T--E-T---M---X----E-M----B--X-----X--o-T--oo-T---|----------o-o------M-|-BB--XfE
m-B|-------XM----?E-T-------E?-----X--B--MMB---|-o-B-BBo-------||-XMM-B-M---E-|---B---?-----o-?-B-XB----oE-TX-?X----?---oT---X-----MM--??XXE-||M---B-M----X---------T|-----B--XT-----B-XT--|T-T----X|--M
XXXXXXXXXXXXXXXXXXXXXXXXXXXXXXXXXXXXXXXXXXXXXXXXXXXXXXXXXXXXXXXXXXXXXXXXXXXXXXXXXXXXXXXXXXXXXXXXXXXXXXXXXXXXXXXXXXXXXXXXXXXXXXXXXXXXXXXXXXXXXXXXXXXXXXXXXXXXXXXXXXXXXXXXXXXXXXXXXXXXXXXXXXXXXXXXXXXXXXXX
