--------o----------------------------------------o--------------------------------------------M--------------------------------------E-------------------------------------------------------E----------
-----------------------?------?--------o-----------------------E--------------------------------------------------------------?-------M--------------------------------------M--------------------------
-?---E-------------------------------------------------------------------------M----------?----------------------------------------------------------------?-E------------o-------E---------------------
------?-------------E------M-----o----------?-M---o-----------?----?---------E---------------------------------------------------------M------o-?--E-------------------------------------B--------------
---------------------------------------B-------------------------------------------------------------------------------------------------------o---------E--------------------E-------------------------
---------------------M-------------------------------------------------------------------------------------------------------------------------------M----o---------------------------------------------
---------------------------------------M---------------------------------?----------------------------?---------------?---------------------------------------------------------B---------------o-------
--------------------------o-------------------------------------------------------------------------------------------------------------------------------------------------------------------------E--v
---------------------------------------B--------------------------------------B------------M----------E--------------------------------------------B-------------M-----------------------E--------B---Ef
---------------------?----------E-----------------------------------------------------?----------------------------------------------------------------------------------------------------------------f
--------------------------------E------------------------------------------M-----------------------------------------------------B---------------------------------------------------------------------f
------------------------E----------------------------M---o--?---------------o-------M------------------------------------------------------E------------?---------------o--E---------------------------f
-----------------T----------------------------------------------------------------------------------------E------------------------------------T--E--------------------------------T---------------E---f
--T-T---T-----------T--T--T--T---------T-----T--T--------T----T-?------T-T-T----T-T--T----------------------T-----T-B--o-T-o--T--------------T---T-------------T-B--T-----T----T-------T---T--T--T-T---f
m-|-|---|-----------|--|--|--|---------|-----|--|--------|----|--------|-|B|----|-|--|-E--------------------|-----|------|--?-|--------------|---|-------------|----|-----|----|?------|?--|--|--|-|---X
XXXXXXXXXXXXXXXXXXXXXXXXXXXXXXXXXXXXXXXXXXXXXXXXXXXXXXXXXXXXXXXXXXXXXXXXXXXXXXXXXXXXXXXXXXXXXXXXXXXXXXXXXXXXXXXXXXXXXXXXXXXXXXXXXXXXXXXXXXXXXXXXXXXXXXXXXXXXXXXXXXXXXXXXXXXXXXXXXXXXXXXXXXXXXXXXXXXXXXXX
