---------o-------T---------B----Bo---------------------------------M-----|-------?---------------M-T-E------M--|-----B---B|---M-----------MB-----------------------------------M---------B-------------|
------M-o----B----E--------B-------------|--X-------------E-------------------E-?--------------------------?------E-----M------M-B-------------------------------------|----------------||---XM--------?
-X--?------------E-M--E--?-----------------E-o----o------------T-?-----E-------T---T--------|--M---?--E--------------E-----M-------------T--M-E-----|-------------BE-----M---B------B------------------B
--------B---MB-------------X|-----?-|-----------------------------?-----?----B-------X--o--?----|--XB-----B----|--------------------B---------T----------------B-|---E-B-----|---------------o----M--?--
----?----------T---------------?----?M---------------B----M-------------------|------------------X-----------------------?---T-X----------------?-?--?----------T----o----M----|----------o-T----------?
-|----------E-------B---|X|-M----o-BE|X---|-----------------------------|---------o--------M-|----E--------------------------------------X---------------M-|---------|-----?----------------X----X-----|
------------?----T------------o-T-B------------T-----------------BX?---------E----M---B------M--E-------------------T--------------------XX---?-B----B------------X------B-----------------------------E
-X?--------------?-------|X------B-----TM--------------------------------------------------------------------------------?-|--------oM----X-----------MT|----------------?-----E?-E----|--------------v|
---EBXM---o--T-?--------B-?--o-----------?-----X-T--B---T---B---XB-----?M?ME--EEX-o?--B---?-oE-BM-M---|o|-M-?-BXT-B--T--T-TT?--M--|Eo-TX---E-|----B----?X--M-oE-----oE-E-B|--|E-o-oT-M-----M--o--T--B-fE
---|-B-o----EMT-E-?----?-----X--B-o--XE--------|-----TX-?|E|-------------T--X---------Mo--B--------E-BX-----B-M-XX-M-oB-B|-T----T--o-T-XoTE-T----?X---|-----oX?---o--E-|--E---X?--T?--||--X-EB-------Tfo
-----E|o-|---|--E----X-----EM-E-?---M------T------M-X-M--?-T|------B---T--------------o|-T----?M-|-M------B-|-------|M--T---X--MT--o-|-XT-E?-M----------------o--M-----M-o-B-?-o?o-EB-----T----E-----|f-
---------?----?-MMoB-M---MM-M-TX----T-X---o--BE|MB-----X-------T---T--o-------------EXTB-|TToX--M-?B-|----|-T-----E-X-B-E?-X--o------?oB-o-o------||-T-o--B-----o-----o-T---E-B----?|X-E--X--?--E--X--fT
-B-XE----B--BB----T--M-|-T----EE--X-T---?-M?-Eo-?-|E-|-X-|B----E?T--XXT?E--------?X----?----Mo---T----ET---EEBE-MoB--?--B--?---B---------?X---T---E--E--M-?---o-----------o---o---------E-oT---E|M-BBof-
-----M---------o|T--T---E------T--T-----M-E----X----oM--o-----B-T--o--o-X-BT-X--oX--X?--o---BXX--X-MX--E|----X-T--M---M-------o------M|T-B--E---??--T--B-B---------B--Bo-|E?T-ME-------|T---o--oT--BB-f-
m-------B-BB--X---|---o?--T-|-X|-------oE-EM-E-----E-----------|-ETX----MB---?--o--|?T----M--B?-B--o----M-|----M--o---------|----XE?----Bo--T--E-o--E---BT--B---o-?----------XBMB----B-|-Bo-T----|-?-|T|
XXXXXXXXXXXXXXXXXXXXXXXXXXXXXXXXXXXXXXXXXXXXXXXXXXXXXXXXXXXXXXXXXXXXXXXXXXXXXXXXXXXXXXXXXXXXXXXXXXXXXXXXXXXXXXXXXXXXXXXXXXXXXXXXXXXXXXXXXXXXXXXXXXXXXXXXXXXXXXXXXXXXXXXXXXXXXXXXXXXXXXXXXXXXXXXXXXXXXXXX
