--------------------------------------------------------------M-----------------------------------------------------------------------------------------------------------------------------------------
--------------------------------------------------------------------------------------------------------------------------------------------------------------------------------------------------------
-----------------------------------------------------------------------------------------X--------------------------------------------------------------------------------------------------------------
----------------------------------------o----------------------o--------------------------------T----------------------------------------------X--------------------------------------------------------
------------------------------------------------------------------------------------------------|-----------------------------------------------------------------------------o-------------------------
------------------------------------------------------------------------------------------------|-------------------------------------------------------------------------------------------------------
------------------------------------------------------------------------------------------------|-------------------------------------------------------?-----------------------------------------------
------------------------------------------------------------------------------------------------|--------X---------------------------------------------------------------------------------------------v
------------------------------------------------------------------------------------------------|------------------------------------------------------------------------------------------------------f
------------------------------------------------------------------------------------------------|------------------------------------------------------------------------------------------------------f
----------------------------------------------BBBBB---------------------------------------------|--------------------------------------------------------------------------------------X---------------f
------------------------------------------------------------------------------------------------|--------------------------------------------------------------------------------------XX--------------f
---------------------------------------------------------X--------------------------------------|--------------------------------------------------------------------------------------XXX-------------f
--------------------------------------------------------XX--------------------------------------|--------------------------------------------------------------------------------------XXXX------------f
m-------------------------------E----------------------XXX--E-----------------------X-----------|--------------------------------------------------------------------------------E-----XXXXX-----------X
XXXXXXXXXXXXXXXXXXXXXXXXXXXXXXXXXXXXXXXXXXXXXXX------XXXXXXXXXXXXXXX-----XXXXXXXXXXXXXXXXXXXXXXX|XXXXXXXXXXXXXXXXXXX-XXXXXXXXXXXXXXXXXXXXX-------XXXXXXXXXXXXXXXXXXXXXXBBBBBBXXX-------XXXXXXXXXXXXXXXXX
