--------------B-----------?-oE----M-----------X-----------X---------------EB--------------?-------------?------M-----EM?---Bo---------------E------------?EM-----?-------X------------M----o----M-------
------------------o----X------------------o------------?-------------------E----------M----------B-------X------------------------M--o-----B-------?-------?-------------------------------------?------
-M-----------o---------EX-X------?---?---o-----------------X---------?-B--------------------?-E---E--M-------------------------B--------------B---------------------------X-----------?-------X---------
----------X-E--------M-----------------XM-------M---------?-----------M--------------B------M--o--------------o-----?--B-X--B--?--------------X--o---M--M------M------?----M------Xo--------E---X---oM--
-?----------------XB-------M---E-------?-?M--E------------o-?---M----B-?----------------o---------------M-XX---BE-----------o--o----X----------------------------?------------------M---------?-----o---
-E--M------B-----B--------B-----------------EXM--------------M--??---B---------E-----M------X-------?--------------BB--------------------?----------------E-------------------------BMo--?B---o---------
----M----Mo------------XX---------M---X--B--------E----M-?---------X-?-----------E--------------------------E----X--B-------?-?-----M-------?----B-----------M-----o?--X--------------------------------
------------M----?---E---B-------------------------?------E-XM--?--B--------------------BM--X-----------E--M?-----M----------o----------?---------M-?M--------X-?--------------------M-------o------B-v-
-----B----o---o--E--------------o--EBB--E--EM---EM-----X-----?--------E--oM--EE-B-BM--------X-o-B-E?--E--X-?---E-XB-------?-??---E---?----X--B-----o-E-o-------------------X--?---?X----------oE----?-f-
--E--o-----X--BE---M---o-E-X---E----B-M-----X---------?---------o----ooEM--?-----?-E----?-------o----Xo---E--?-------BEXB-M--?X-?-E------B-?E-X--M--------Xo------B?----------?-X-X-----B-----?-M-X--of-
---oEX---?-------------B--X---------X--M----o-----o------E-??-E--E-B-M--------X---------------------o--------M------M-X--?-MB-X-M--------B---o?-----------o----E--M---E---E-MM----Xo--o---------o-M---f-
----EXE--?-----B-----M--M---BX--?----MB------Eo---M---?------X-----XE--M----------------?B--------B-----M-----Bo-----M---E----?-----?B-------o-B-------oo------X------o-BB--o--?M--B-M-------?o-?----Bf-
--B-XMBB---o--X---B------B---MM--XM-----------ooo-X---o------?-----EB-oB--M-E-E---M----?-X----X--B---E--?B-M-Mo-----------BMB---X---M---X----------?XB--M----E----M----?--?X-----oM-E-E------E-B------f-
----o--TE?---TTE-o-------T---BT-?B-M----XTXX--?-?-----?-E---?BTTToT?--T----E-M-?XX-M---T-T--XE-TB-X---T-X--M---T-B----B--TBX--------o-T---TTToT-M---EB--?-----T----EE------?-T-T---XTT----X--------BTMf-
mE----B|-?---||E-T--o?---|--T-|--MB-o----|---?-T--E|-o-B--|-EM|||?|--B|XB----X---?MoEM-|T|B-?--|MX---E|Eo--E---|---T-T---|-|-T---EoE?MXX-||||-|X-MMM--M-T----M|----M----M--E-|-|-o--||-T-??--E--?---|-f-
XXXXXXXXXXXXXXXXXXXXXXXXXXXXXXXXXXXXXXXXXXXXXXXXXXXXXXXXXXXXXXXXXXXXXXXXXXXXXXXXXXXXXXXXXXXXXXXXXXXXXXXXXXXXXXXXXXXXXXXXXXXXXXXXXXXXXXXXXXXXXXXXXXXXXXXXXXXXXXXXXXXXXXXXXXXXXXXXXXXXXXXXXXXXXXXXXXXXXXXX
