------------??M-E------E-?-----------------?---?---M--E---------------E--------|------------E--------------------------------o----------------------oB-------M----?------B-----|------T-B------X-|B--X--
----------E-----E-B---------------BBB--------T-|---------------------B--?o------------------M------E--------|-------BXo-B---------T---------o-T-X-T-------------------o--B-------M-------|-X-M-X-------?
----|-B-------------o-----?---------|--------------------T-?-----|-?-----E---EB---XB---o---X------X-----------B--------?-o---|--?-----|--T--------TM----E------B---|------T--o-------------E------E----|
--------------------T------------X---------|-----------------?--------X--------M-M-E----------o-----X-----------B-------X-----------------XXE----------|---|--?--X----E---------E---?-T------------X---|
-----------X--E--M-X--------|X----TM-?--------------?------T---o--B---------|-----T---------------------|------M-BE----------------------------EE--T--------E------------------M-----------------------|
-----------BB--M----X---------------------|o--T-----------------T--o----------------?-----MXE-------------------B--------?-----------T--------------T-X---------B----M---------?o----E-?---------------?
--------------------o----TE-----X--|M--M---------E-BT------------------------------------------------X-------T----M-?-E-o---|---------------X----B-------------------------------X-M|T---------B-E-----X
-------|-----B-------M--------o|--o-------------|-----BoB-----------T--|------M--E---------B-MX---------------------------------------o--------------EB-o----?------?-------|--E----M----|------------vT
--XMT--------------|X------?E-X------TXo---------B-T-o-oEXoM|--o-----?--T|B-?XT------E----|---|o--TT-o--------------X--?---M-XoBEX-M---o--|Eo--o-EBT-|--MTBo---oEE---E---------B--EEB-BX-------o?--M--f|
---------------BTT-?-|---B--|-----|E--BM--T--|--------B|X-X-----X-----EX--E-?B---X--|--T-T---M-B-M-------TBM|M-X---?E------------?-M--o-TT-------B-M----|-X----E-B-TM--o--T-|-M--oM--o-oo----?T-T----Xf?
-X---M--T---BTM-?---EB--EB-X--M--T---E-------T?---------?------BT-o-MM--TE----XM?B|To------ME---M-B-M--E-------M-E---|-------------Xo--?--X--o---Bo----X--??----|?||----BE-M----|MT----M-|---X-|-B--M-fX
----------B-?----M--E---M-?X---|?o---B--?-oE--T---|X--B--BT-?M----E---oMT--M--M--B---XM----X--BEX|?---ET------M---E--T--?|--T-oB||?o-B-X---X||--E--|---MB-|M-------XTo---?--TXE------E----E-?B|---?-|-f?
-X?---?-??MBB?---||Eo----|-X--E--E-o|B-T-X-X--?ooX-?----------oXE----o--?M---BEB----?M--?---|--M-o--E--XX---T--TET-M--|-Xo-E-T--o-E--B-|-M--o-|--T-----------o?||oB----?-B-E-?E---ME-E-----MBE-?--|T?-f-
------B-|-----o--M--------BET-E-----------|EB--------?-------B--------E--X--T----------XT----XM-----T-M-EoT|----B----o-TX-BT-M-E--MTTToB-----T-----?----To?ET-?--XB-----MX|---M--oT-X--E----T---XBB-oTfT
mX-----E---?-----M-----o--M----MT---X?---o-|--||---------?-B-X--E-----B-X-------o-?---X-------------T--MB-M---?o--M--T---T|-MBo---XTBM?------B-------E?-E-M-----o?----B-o---?---EE-?TXo-|-?-o---o-?----B
XXXXXXXXXXXXXXXXXXXXXXXXXXXXXXXXXXXXXXXXXXXXXXXXXXXXXXXXXXXXXXXXXXXXXXXXXXXXXXXXXXXXXXXXXXXXXXXXXXXXXXXXXXXXXXXXXXXXXXXXXXXXXXXXXXXXXXXXXXXXXXXXXXXXXXXXXXXXXXXXXXXXXXXXXXXXXXXXXXXXXXXXXXXXXXXXXXXXXXXX
