-----------X---------------------------------------------o-----------BBBBBBB-----------------------------------------?-BBBBBBBB---o---------------------------------------------------------------------
------------------------o-------------------------------------------------------------------------------------------------------???????--------------------------------------------M-------------??????-
-----------M-------------------o-------------?-----------------------------------------------X---------------------------------------------XXXXXXX--------------------------------------------?????-----
-----------------------------T--------------------B--T----B------------------------o-----------BBB------------------------M----????????-------------?------B--------------------------------------------
------------------------?----|-----------------------|-o------------------o------------------------------------------------o----------------------o-----------------------------------------------------
------T---M----------X-------|-----------------------|---------------------------X-----------------------X----------------------------------X--------X------X----------------------------------M--------
------|----T----T----XX------|--MBBBB----------------|------???------------------XX----------------------XX-------------------------------oXX-BB-----XX----XX--------X--?-------------------o-----------
------|----|----|---MXXX-----|-------------------B---|---------???????-----------XXX--XX-----------------XXX-X----------------------------XXX-T------XXX--XXX-------XX---------------------------------v
------|----|----|----XXXX----|-----M-----------------|---------------------------XXXX--------------------XXXXXX--------------------------XXXX-|------XXXXXXXX------XXX-------o-------------------------f
------|----|----|----XXXXX---|-----------------------|-----------------------?---XXXXX-------------------XXXXXXX-------------X----------XXXXX-|------XXXXXXXX-----XXXX--------------M---------o--------f
------|----|----|----XXXXXX--|-----------------------|---------------------------XXXXXX------??----------XXXXXXXX-------B---XX---------XXXXXX-|------XTXXXXXX----XXXXX-------------------M-----------X-f
------|----|----|----XXXXXXX-|-------------------o---|------------T--------------XXXXXXX---X-------------XXXXXXXXX---------XXX--------XXXXXXXX|------X|XXXXXX---XXXXXX----------?--------X----------XX-f
------|----|-B--|---?XXXXXXXX|-----------T-----------|------------|--------------XXXXXXXX--XX------------XXXXXXXXXXBBBB--TXXXX------XXXXXXXXX-|----X-X|XXXXXX--XXXXXXX-------------------XX--------XXX-f
--T---|-T--|----|----XXXXXXXX|-B-----?---|-----------|-----------?|???-----------XXXXXXXXX-XXX-----------XXXXXXXXXXX-----|XXXX------XXXXXXXXX-|--BBXXX|XXXXXXXXXXXXXXX-------------------XXX------XXXT-f
m-|---|-|--|---E|--?-XXXXXXXX|X----------|E---Eo-XEE-|------------|-------E------XXXXXXXXXXXXXX----------XXXXXXXXXXXX--EX|XXXX--E--XXXXXXXXXX-|----XXX|XXXXXXXXXXXXXXX-------------------XXXX----XXXX|-X
XX|XXX|-|--|-X--|----XXXXXXXX|XXX--XXXoXX|XXXXXXXXo--|XXXXXXXXX---|--XXXX--------XXXXXXXXXXXXXXXXXXXXXXXXXXXXXXXXXXXXXXXX|XXXXXXXXXXXXXXXXXXXX|XXXXXXX|XXXXXXXXXXXXXXXXXXXX--------XXMMXXXXXXXXXXXXXX|XX
