-------------------------------------------------------------------------M---------------------------o--------------------------------------------------------------------------------------B-----------
-----------------------------------------------------------------------------------------------?????---------------------M------------------------------------------------------------------------------
--------------------------------------------------------------------------------------------------------------------M--------------------------------------------o--------------------------------------
-------------------M--------------------------------------------------------------------------------------------?-----------------------------------------------B-M-------X-----------------------------
----------------------------------------------------------------------------------------M---------T---XXX-----------------------T------------------X----------------------------------------------------
--------------------------------------------------------------------------------------------------|-----------------------------|----------------------B---------------------------------------T--------
---X-----------------------------------------------------------????-------------------------------|------------------X----------|--------------------------------------------------------------|--X-----
-----------------------------------------X--------------------------------------------------------|---?-------X------XX---------|----------???????X---------------XXXXX------------------------|-------v
-----------------------------------------XX----X------------------------X--X-----------------M----|----------XX------XXX--------|----BBBBBBB------XX-------------------------------------------|-------f
-----------------------------------------XXX---XX-----------------------XXXX----------------------|---------XXX------XXXX-------|-----------------XXX--T-------------------------BBBBBB----T---|-------f
-----------------------------------------XXXX--XXX----------------------XXXX----------------------|--------XXXX------XXXXX------|-----------------XXXX-|-----------------------------------|---|-------f
-------------------------T---------------XXXXX-XXXX-----------------X---XXXX-----o----------------|-------XXXXX------XXXXXX-----|-----------------XXXXX|----------------o------------------|BBB|-------f
-------------------------|B--------------XXXXXXXXXXX-------------?-XX--XXXXXX---------------------|------XXXXXX------XXXXXXX----|------T----------XXXTX|-----------------------------------|---|-------f
------------------X------|---------------XXXXXXXXXXXX-------------XXX-XXXXXXXX--------------------|-----XXXXXXX------XXXXXXXX---|--T---|----------XXX|X|X--------X------B???????-----X-----|---|------Xf
m-----------------XX-----|----X----------XXXXXXXXXXXXX-----------XXXXXXXXXXXXXX-----E--E--E-------|----XXXXXXXX------XXXXXXXXX--|--|---|----------XXX|X|XX------XX------E-----------XX-X---|---|-----XXX
XXXXXXXXXXXXXXXXXXXXXX---|----XXXXXXXXX--XXXXXXXXXXXXXXXXXXX---XXXXXXXXXXXXXXXXXXXXXXX-XXXXXXXXXXX|XX-XXXXXXXXX----XXXXXXXXXXXX-|XX|XXX|-------XXXXXX|X|XXXXXXXXXXXXXXXXXXXX-XXXXXoXXXXX-XX|XXX|XXXXXXXX
