-----------E-------T--------------------|-------------B----------------B---?E------------T---T---|||------|-?E---B---M?--M-X--------|-------?o-X-B----E-----------B-E----------------------T---M-------T
-o----BB--o---M---X--------|-?-----------------------------------------|----oXB---------------BM----------------------------------E----X-B---XB-------X--o-o------------M---M--X------------B--T--o----B
--?--M-----B------------M--------------------|--B-?------|-----------------------------------M--------------M--|-------|-----B---E----------|--E-------T-----Bo------E-----o---o-------------B----o----|
--------o---------M---Mo---T-------?-----T--------------M-----------|--?------|-------M-------T-T-------?--?-----X---------------E--E-|--X--------------------M------------E----X-M--------------M-E---o
-----------------X-----M--E-?-----E-B--------T-B--------------M-------B---------------|-------------E--T--B-----------M|?X------------------------------?----|-------|---------------o-------E---------B
--------------o--o--|---------?---|-----E-----EB-------B----------o-----------------E---------------E--|----M---------?-B-|-----M?-|-o------------T--ET-----------M----|----|-------M--T--------T---?---
-----B---------------------M--T-------------o--------E----M----X-------ME?T----o-B------------|----------------------|B--------------T----------T-----------X-----------------------?------------------E
------E?-----?-?-o--?------XX--B--------|-----B--|----M-----|----M-B---------------------------E-----|-|---E-------|--E---------------o------M-|------E------------------------X|-------------T----T--v-
--|--T---E--?BE--|------?-|---To-----------MM---X---o--BB--XoX--------?---X---Xo-?-M--T--X-?-------To--X|--T----------B-|X--B|B?-o-o----E----T-----o|-?-XE--o--o-------E-M--X-MoM?o-----|-?X-TE--E?---f-
-----o------X---oB----T-?oEM-||T--MT---M-------?--?-|EoTBT-EEE-o?----|----T--?--T---XTT-T---?---M-T--|--o----o--|-o-o-M?----|-B--TT|-E---?---XM---o--X-MTo-X----?--?BE--?---E--o-ET-M-----MXo-|--?----fB
--X---M-|-M----X|----EX-||-X--T-X|-o-oB--|--M--MBX----|-E---E?M|M-T---o--|E--------------M-?-----?o----X-B-BM|-M|--|--XTX---|--M---XT---B---------------BT-MB-E--EM-------B-o---o------X---|-E--------fT
--E--?----?T----EM-X-----?----X?-|---B-E------------E|T-----o-M---|-------------E---E-----oB-|-Xo--?M---|---B-o-X-E?--|-E--?-|---XE|--X------M--------------|oE|-|-B---|-o-------------M-M---||X------f-
--?--?-TMoM----------|-o-E---Xo-E-XB--M-||B-----M-------|-X---E-----T-o-----T---Eo?|-M|X|-oEX-ooE----?TX?X-B-----?-E--MM------|E------XXBE-BM--TMEo|---|B---E|---------TE--X---o----?o--XMo--o--M--||TfE
-M-E---o-BEo-B-X--------X---MTX---M-?-E--------?--------M--T--------T|----?X--X---o|M-?-E|----E----------o--T-----|X---E?-T-BX--M-?---?oXX-M-B|-----|-o---oMoXo-X---EoT---E---o---o-??----o-|?X--|?-E-f-
m-o---E---X?--?--|BT------B----o-B-------M--E--TX-|MX--ToX-|-ME-E|-X-B----|-XB-X-T-----B--------?EX?-B--B--X--|-B---?-?----BX-M-T----E-E------o-TETBE-----T|-B--|-------|EB-?----?----M--T---E--XE---EBE
XXXXXXXXXXXXXXXXXXXXXXXXXXXXXXXXXXXXXXXXXXXXXXXXXXXXXXXXXXXXXXXXXXXXXXXXXXXXXXXXXXXXXXXXXXXXXXXXXXXXXXXXXXXXXXXXXXXXXXXXXXXXXXXXXXXXXXXXXXXXXXXXXXXXXXXXXXXXXXXXXXXXXXXXXXXXXXXXXXXXXXXXXXXXXXXXXXXXXXXX
