-|------------------X------M--------M----E-o-|--------M-----------E?EM?---------?----TM-----B---------B-----------T-o--|--E--------E--------oX-|B-----?--------------M------------B?--o--E----B--Xo----|
-----------M-|--B-----o--EX----------------o---------------------------E-X-------------X--?-----T---------------o----B--------X---------|---------T---|T---E----------|----------------T----------B----M
---?--------------------o--|--------M-----------oM-?E---X------------------------------------------E---------------B--X----------|---------------------------T--T-X------------M------------X----------T
--?X---E------------|----M----?------BM------o-------M---oX-------X----------?-----?oX--B--X-?-------X-|-T------------B-------?-------MB---B-----------------------------E-----------------------------?
--------|-------To--T---------X---------------T----?---oE---?-|---X----------M--------T--------oT---------M------B-----X-T---E--------??------X-----?-T--------------E|-----E-E----------T-------------B
-----M--|------o---?----ET-M-----B---|-o|-----------|---B----Bo--?BX-----------M---------E--o--X--------E--------------T-X----------M--------B---B-B-------------?---o--------------B--------?---------B
---------B--E------------------M------|----o----T-------TM--------------B--M----------E-------oE-----------------E--------------?---E-------------X---------------M--T---------------X---X-------E-E---E
------o--------------o--------o-----o|-X---X---B-M--M-----------?---------------|-X-?M----------------------?--T-------?--M----------------------------B-----T----E-|-XM|-E|XX|X--------------------M-vo
--X-X-X|-----T-T?-----T--|-M|?-T?--TM-?-E-X----MT|TE------------T----------BX-B-oM-----------?-----E--|BTo---T---X---B-B--?--T--T-T?T--|--o-----X---M-B----M---M-T----BE|-?-------?---T-M--|-|--o----EfT
---------E---E-M----Bo---MT------T---E-X------M--|E-----B-o?-T|-T-o----oBo|--X-T--T-|TM-ooEB----o--M?E?E?-TB|----M----M---o---M--?-M-|--|--E--|-oX---B--|--o-M-----BXE----|---M--X-B--T?--XM--M---M-EEfB
-T-B-M--ToB--ET-o--XX?-o---E--X-------|?---B--T--X---E-------o?---E-E-Bo?--E-EE-MMo-X--E---M--?--|-----oT---|-oB-------?B---TBX-----TT---T-|-----BBB---X-|--E------?|---oo-----E-B-X-E--B--|--------B|fB
-E?--EM----?----|--?--------o----|--T------?--|-MB---o-o-B----------o-E----E---?---o----B?-?-B---o--MB-E--?E-?E-o-o---B-EX-----------EE---o--MT-T|--BX-?ME---X-E--Eo--|--E-M----M-Mo?--TBB--T-X--X----fo
--E-----?--E-B-E--X-?MB------------E-----B------o--?B|o---X-B--o---?---o?---?M|----?B-T-------?TX--?---B------------MT---T?-E---|E-M---EoX-B-X----|---------?----T|?X--X---?--?---B-M---MoM|----|B----fE
-o-o--M----X-o---T?-E-?----o--T---|-M---E----E---o----M-?----EEM--X--M-----E-?-T-X-Moo--BEX|-BXE--M--X-?MT--ME?oXM--E-X----E--|X?M--M---??B-MB---o----oB--oM--|---|--|--?BE----M-E-o------XEX---|o-MT-fM
m-o--E--?|-------|--o---|-TT-|-|---o-o--M---B-----------o------B-X--T----M-T?|--o----X-X-?---E-MM--o-TB----T---oEB-?-o----To|---|------T-------B-?T-----------E--ETX-----|------B---?--Mo|?-----X-----TB
XXXXXXXXXXXXXXXXXXXXXXXXXXXXXXXXXXXXXXXXXXXXXXXXXXXXXXXXXXXXXXXXXXXXXXXXXXXXXXXXXXXXXXXXXXXXXXXXXXXXXXXXXXXXXXXXXXXXXXXXXXXXXXXXXXXXXXXXXXXXXXXXXXXXXXXXXXXXXXXXXXXXXXXXXXXXXXXXXXXXXXXXXXXXXXXXXXXXXXXX
