-----------------------------------------------------------------------------------------------------------------------------------------------------------------B--------------------------------M-----
-----------------------------------------------------------X----------------------------------------------------------------------------???--------------?????--------------------------------B---------
------?-------------------------------------------------------------?---------------------------------------------------------------------------------o-------------o-----------------------------------
----------------BBBBBB-------------------------?---------------------------------------------------------------------------------------------BBBBBB-----------------------------------------------------
--------------------------------------------B-----T--o-----o--------------------T--T-X---------------X--------------------------------X------XXXXX------------------------------------X-----------------
--------------------------------------------------|?--------------o-----------X-|--|XX----------------------------------X------------XX-------------o-------------------????----------------------------
------------X----------------------T-M---------T--|T---BB-----?--------------XX-|--|XX-------------------------------M--T----o------XTX------------------------X----------------------------------o-----
-----------------------------------|-----X-----|--||------------------------XXX-|-X|XX----------------------------------|----------XX|X-----------------------XX------------------------X--------------v
-----------------------------------|----XXo----|--||-----------X--X--------XXXX-|XX|XXB------------------T--------------|---------XXX|X-------------T--------XXX-----------------------XX-B---o---M----f
-----------------------------------|---XXX-----|--||-------------XX-------XXXXX-|XX|XX-M-----------------|---o-------o--|o-------XXXX|X-B----o------|-------XXXX------------T---------XXX--------------f
---------------X-------------------|--XXXX-----|--||------------XXX------XXXXXXX|XX|XX-------------------|--------------|-------XXXXX|X-------------|------XXXXX------o-----|--------XXXX--------------f
-------------X------------------M--|-XXXXX-----|--||-----------XXXX-----XXXXXXXX|XX|XX-------------------|------X-------|------XXXXXX|X-------------|-----XXXXXX------------|-------TXXXX--------------f
-------------XX--------------------|XXXXXX-----|--||--???-----XXXXX----XXTXXXXXT|XX|XX----????-----------|--------------|-----XXXXXXX|X-----------?-|---oXXXXXXX------------|------X|XXXX------------X-f
-------------XXX-------------------|XXXXXX-----|--||---------XXXXXX---XXX|XXXXT||XX|XX--------T----------|--------------|----XXXXXXXX|X-----------X-|---XXXXXXXX------------|-----XX|XXXX-----------XX-f
m------------XXXX------------E----X|XXXXXX-----|--||----E---XXXXXXXX-XXXX|XXXX|||XX|XX-------E|----------|--------o-E---|--oXXXXXXXXX|X-----------XX|--XXXXXXXXXo-----------|----XXX|XXXX----------XXXEX
XXXXXXXXXXXXXXXXXXXXXXXXXX-------XX|XXXXXXXXXXX|XX||XXXXXXXXXXXXXXXXXXXXX|XXXX|||XX|XX--XXXXXo|X-XXXXXXX-|--------X---?X|--XXXXXXXXXX|XXXBXXXXXXXXXX|-XXXXXXXXXXXXX--XXXXXXX|XXXXXXX|XXXXXXXXXXXXXXXXXXX
