----------------------------------X---------------------------------------------------------------------------------------------B-----------------------------------------------------------------------
-------------------------------------------------------------------------------------------------????????-----------------------------------------------------------------------------------------------
-----------------------------------------------------------------------------------------------------------------------------------B---------?----------------------------------------------------------
------------------------------------------------------------------------------------?--------------------------------------------------T-------------------------------------B------------------????----
-----------------------X---------------------------------------------------------------------------------------------------------------|----------------------------------------------------------------
-----------------------------------------------------------------------------------------------------------------o---------------------|-------------------------------------------------------------XX-
--------------------------------------------------------------------------------------?------------------------------------------------|---------------------------------X------------------------------
-------------------------------------------------------------------------------------------------------------------T-------------------|---------------------------------XX--------?--------------BBBBBv
-------------------------------------------------------------------------------------T-----------------------------|-------------------|---------------------------------XXX---------------------------f
-------------------------------------------------------------------------------------|-----------------------------|-------------------|---------------------------------XXXX--------------------o-----f
-------------------------------------------------------------------------------------|---------------------------X-|-------------------|---------------------------------XXXXX------------------------Xf
-------------------------------------------------------------------------------------|--------------------------XX-|-------------------|---------------------------------XXXXXX-----------------------Xf
-------------------------------------------------------------------------------------|-------------------------XXX-|------T-X----------|---------------------------------XXXXXXX----------------------Xf
-------------------------------------------------------------------------------------|------------------T-----XXXX-|------|-XX---------|---------------------------------XXXXXXXX---------------------Xf
m-----------E------------------------------------------------------------------------|------------------|----XXXXX-|------|-XXX--------|------------------E--------------XXXXXXXXX--------------------XX
XXXXXXXXXXXXXXXXXXXXXXXXXXXXXX-------XXXXXXXXXXXXXXXXXXXXXXXXXXXXXXXXXXXXXXXXXXXXXXXX|XXXXoXXXXXXXXXXXXX|XXXXXXXXXX|XXXXXX|XXXXXXXXXXXX|XXXX--XXXXXXXXXXXXoXXXXXXXXXXXXXXXXXXXXXXXXXXXXXXXXXXXXXXXXXXXXX
