-----T----------------------TB----------XT------o-B?---------o-------TB--------------------E---------o--|-------?---X---------B-BX------X---------------?-------------------------B--T--------E---------
---?--o--|--E-----------------------------------X-----------|-M-X-?------E----------|----T------------o--------o-----M--------------------------------------------T-o--------M---o-?---?----------------
---------------------------E--------T?------X---------------------------------|E----T----M-|-----------------------M---------|--------o|B---------|---?--|---E-----------------------------?--X---------
---T---|-----B-----------|----M-----------|-------B--------------Xo---MT--EE|o--?E---M--?--B--T----------B--------T------M--------------?-----E--------B-------T---?--------M-----------M------X--------
------M--M--M---------------------------To--------|-----B-X----XE?---------o----o----------o--M----??M-------------------?-o---|-M------------M-------E-?--?---|----------------------------X-B---------
------?----|--B-----M--X----------T---------BoM------X------------|--E--X---X---------M-X----T--|---------------|--o-----X-E--|-B------o---------|B---------------T-----|----------|-T----------M-------
---B----B----M--E--------B--?------M----T-------------X-----EE-----E-----------?--------------------?----------M--------------------T-----------------E-----------------T-----?----------B-------B?-----
---T-------TT-o-----M---X---B-E------M-o-------E|-----B----?---------T----------------------------|-----?------E------T-------E-M--X-----E-------------------B---oT-T--T----------M--X---oE-|--|-----E?v
-E-----B-----T--o-----?--X---?--oBB-ME-B--?-E---?TB-----M-----XB?--TB----E|?X---|?--B----------o---------X-B-----M-oE--TEX---T---TX----ETE--T--E--XXo----XX-?---B----o|EoXET--------X----------oo---?-Xf
-|-----?---|----?|E|-M---?|-oX-o-EEE--|-EB--XMX---ME--|----o-X--XT----o----|-|-M--T-ME----B--EE-M--?o----EE-o--|B--|---?BX-ET----X--E-XB------|-o?B----T--oB?--??------??--------Mo|B-X---?----X-?E-T-Bf
---T-ToE----M-E-XX-E----T---T--M-M-----|------???-BB----X-X-Eo---?|--M--o--X-----?M-M--E-|-B-----B--|X---B-|---E-B?-EXB-??--o--B-----?----|X--oM-----|------T?------T|---B-o---TE-B--T?--XE--|E-MoB--M-f
--------?---o-------o----?E---E|---Mo-X-M-----?-----------M--ToT-M|--------E|B-------?------BX-BBX?M|oMMBM--E|-EX-|o------TMM-o-TB-------M----MB-M------X-----oB-T--|--|B-----o-----M-T--o-----MToT?--Bf
-XTB?B-T-------o--To--?-E--B------M--------|---?--MX--X-B--|-|--B-----T--E--|-?--------|-E-----T--o|--T-TM-B--M-M?--|-TT--M-|------T|--T-----T--B--------X----------|--|oM---o-BoB|---XT-?B-X----E-----f
---X-----o-B----M-E?B?-BT--E-|---?----o--?|?EE---?-------M-|---B--MBB----B--M------X-B|--E|?---B----TE--E||--|-X-B--B-T||B--TE--------?-?-X------?TEB-E--?------?M--?-EM----o-|-T--X----|-E--?-----|TB|f
m-T-o--|B|---?-------TX?o--B------|EM--T-|E--|-XE-EM----o-----EX-To-----?-M-B--M--E----------------Mo----|M--X-|---E----Bo-E-------o-----T-----T--M------X-----oo---X-BBE---XMo---Eo?M?-|----E----M-TX-f
XXXXXXXXXXXXXXXXXXXXXXXXXXXXXXXXXXXXXXXXXXXXXXXXXXXXXXXXXXXXXXXXXXXXXXXXXXXXXXXXXXXXXXXXXXXXXXXXXXXXXXXXXXXXXXXXXXXXXXXXXXXXXXXXXXXXXXXXXXXXXXXXXXXXXXXXXXXXXXXXXXXXXXXXXXXXXXXXXXXXXXXXXXXXXXXXXXXXXXXX
