--------M----E--X------------?------------?M------E------------------------Bo----B-------------------------o-E---------E--B--------------------------M--------------------?--------?--?----o-----------|
--------B---X-----------------B-----E-M----------------o---o-------------M?-------o-------B---o----M-----?--------M----?----------------M---------M------B--B------------------------------------------?
---------X---------------------M--X----------------o----M-o-----B-B-------------------B----------------?------o------M-----B-----------------------M--B--M-----E-------------BE------B--------------B--?
--E--o------------B-----------------------o------E-----?-------MXE----------------------XX--------o--?-----------?----------X--M---o-------------------B------B--------------X-------oX-----E--Mo------X
------------------------------------?---------E--------------------------M------?-----o------B------o-----------------------------------E-----X-----------?M-----------------------?-------------B---M-?
--X--M------E----------o--o--X----o-----X-------ME-----------------------------?----------B---------?-------------o-----------M----------?-----E-----E----?-----------X--------B-------?----------------
------B----?-------?-----X---------------Bo-----------------------------EB----------?----------------------M--------------------------?-E--------------o-----BoE----?-------------E-----X---?----o-----?
-------------B-----o----T---T------------?o-----BXX----------B------X--M------M------------o-------X-----------B---E--------------------X---E------B----------?---E--------?--------MB-----E----------vT
------B?oo--EM--XX--------o-X--B?-----------M-X---E--o-B---E-------M---?-------E-M--?--------M--BM-B------B---o--M--?-X-----X-XB-?---X--oB---------B---M---X--?--?--------------------MXo--??-o-E----MfX
-oT-----oo-o-----o----------oM-------?-M--M-------o-?------??--E----?---M?--M----E---o-?-----------B-----M-B-----?--E------oo---X-E--oB------EE-X----B-------B--?o?----X--BE--E------?-X--M---Xo---?E-f-
--X-M---o--?------------X--------?--M-X-----Bo-E---o----------B----M--B---?----T--XT-M--------M------EB---M-M?--?-B----X-----o-?---M----BBB--M------?-?-X---M--B----M-----X----------?EXT----EMM-BE---f|
--------X-------oM-?B----?---B------E-----X-BX------B------MX----E-----T-X----o|---X-?--E--------o------EE---------o-?------X--o---X----E-MB--?X-?---B----?oE-----M--?---?-?M-B----?--B-|------M----o-f?
-ME-ME-------o--B---B--?M-X--?--o-----------------MM----?X---EM---?----X---X---X----M----?--EBM----EB------B-EB--M--M-M-------------E----?---M-----------X-----E-E-B---M-?-?--o-------B-X--ME---o-----fo
--?XT-B---MT--T-EBM---EoE-T-M---TX-T--E--B---o-M-T----X--TTB----oE?-----BX-----T-TM---?--?B--M--B----------?-MT-------ME-TT--T?---T--X-----T-E-E--MMo--TM-----MTE--M--EM--?---E--Xoo--T-T----?BTMT--BoT-
m---|--T--T|--|?-o-----ME-|--|-?||T|B|EBMoX-B---o|--?E?-B||-----?----T-||?-B---|T|-TE--------B-TB---X------T--|--?----Bo-||X-|B-?X|XB-BT---|M-X----?T--|M-M----|XBBX-E------EXBB-----o|-|------|-|-o--|X
XXXXX-XXXXXX-X-X-XXXXX-X-X-XXXXXXXX-XXX-XXXXXXXXXXXXXXXX-XXXXX-XXXXXXXXXX-XXXXX-XXXXX-X-XXXXX-XXX-X-X-XXXX-XXXXX-XXXXXXXXX-XX-X-XXXXXX-XX-XXXXX-X-XXXXXX-XX-X-XX-XXX-XXX-X-X-XX-X-X-XXXXXX-X-XXXXXXXXXXX
